ACTGGTAACTT -> CTGGTAACTTC
CTGGTAACTTC -> TGGTAACTTCA
TGGTAACTTCA -> GGTAACTTCAA
GGTAACTTCAA -> GTAACTTCAAA
GTAACTTCAAA -> TAACTTCAAAG
TAACTTCAAAG -> AACTTCAAAGT
AACTTCAAAGT -> ACTTCAAAGTA
ACTTCAAAGTA -> CTTCAAAGTAA
CTTCAAAGTAA -> TTCAAAGTAAA
TTCAAAGTAAA -> TCAAAGTAAAC
TCAAAGTAAAC -> CAAAGTAAACC
CAAAGTAAACC -> AAAGTAAACCA
AAAGTAAACCA -> AAGTAAACCAA
AAGTAAACCAA -> AGTAAACCAAT
AGTAAACCAAT -> GTAAACCAATA
GTAAACCAATA -> TAAACCAATAC
TAAACCAATAC -> AAACCAATACT
AAACCAATACT -> AACCAATACTA
AACCAATACTA -> ACCAATACTAG
ACCAATACTAG -> CCAATACTAGA
CCAATACTAGA -> CAATACTAGAC
CAATACTAGAC -> AATACTAGACC
AATACTAGACC -> ATACTAGACCT
ATACTAGACCT -> TACTAGACCTC
TACTAGACCTC -> ACTAGACCTCT
ACTAGACCTCT -> CTAGACCTCTG
CTAGACCTCTG -> TAGACCTCTGA
TAGACCTCTGA -> AGACCTCTGAT
AGACCTCTGAT -> GACCTCTGATG
GACCTCTGATG -> ACCTCTGATGT
ACCTCTGATGT -> CCTCTGATGTC
CCTCTGATGTC -> CTCTGATGTCA
CTCTGATGTCA -> TCTGATGTCAC
TCTGATGTCAC -> CTGATGTCACG
CTGATGTCACG -> TGATGTCACGG
TGATGTCACGG -> GATGTCACGGG
GATGTCACGGG -> ATGTCACGGGT
ATGTCACGGGT -> TGTCACGGGTA
TGTCACGGGTA -> GTCACGGGTAG
GTCACGGGTAG -> TCACGGGTAGT
TCACGGGTAGT -> CACGGGTAGTA
CACGGGTAGTA -> ACGGGTAGTAT
ACGGGTAGTAT -> CGGGTAGTATG
CGGGTAGTATG -> GGGTAGTATGC
GGGTAGTATGC -> GGTAGTATGCA
GGTAGTATGCA -> GTAGTATGCAG
GTAGTATGCAG -> TAGTATGCAGT
TAGTATGCAGT -> AGTATGCAGTA
AGTATGCAGTA -> GTATGCAGTAA
GTATGCAGTAA -> TATGCAGTAAG
TATGCAGTAAG -> ATGCAGTAAGC
ATGCAGTAAGC -> TGCAGTAAGCC
TGCAGTAAGCC -> GCAGTAAGCCA
GCAGTAAGCCA -> CAGTAAGCCAT
CAGTAAGCCAT -> AGTAAGCCATA
AGTAAGCCATA -> GTAAGCCATAA
GTAAGCCATAA -> TAAGCCATAAA
TAAGCCATAAA -> AAGCCATAAAG
AAGCCATAAAG -> AGCCATAAAGA
AGCCATAAAGA -> GCCATAAAGAA
GCCATAAAGAA -> CCATAAAGAAG
CCATAAAGAAG -> CATAAAGAAGT
CATAAAGAAGT -> ATAAAGAAGTC
ATAAAGAAGTC -> TAAAGAAGTCT
TAAAGAAGTCT -> AAAGAAGTCTT
AAAGAAGTCTT -> AAGAAGTCTTA
AAGAAGTCTTA -> AGAAGTCTTAG
AGAAGTCTTAG -> GAAGTCTTAGA
GAAGTCTTAGA -> AAGTCTTAGAG
AAGTCTTAGAG -> AGTCTTAGAGG
AGTCTTAGAGG -> GTCTTAGAGGG
GTCTTAGAGGG -> TCTTAGAGGGG
TCTTAGAGGGG -> CTTAGAGGGGG
CTTAGAGGGGG -> TTAGAGGGGGG
TTAGAGGGGGG -> TAGAGGGGGGT
TAGAGGGGGGT -> AGAGGGGGGTT
AGAGGGGGGTT -> GAGGGGGGTTC
GAGGGGGGTTC -> AGGGGGGTTCT
AGGGGGGTTCT -> GGGGGGTTCTG
GGGGGGTTCTG -> GGGGGTTCTGA
GGGGGTTCTGA -> GGGGTTCTGAA
GGGGTTCTGAA -> GGGTTCTGAAT
GGGTTCTGAAT -> GGTTCTGAATG
GGTTCTGAATG -> GTTCTGAATGT
GTTCTGAATGT -> TTCTGAATGTC
TTCTGAATGTC -> TCTGAATGTCG
TCTGAATGTCG -> CTGAATGTCGT
CTGAATGTCGT -> TGAATGTCGTA
TGAATGTCGTA -> GAATGTCGTAT
GAATGTCGTAT -> AATGTCGTATG
AATGTCGTATG -> ATGTCGTATGC
ATGTCGTATGC -> TGTCGTATGCA
TGTCGTATGCA -> GTCGTATGCAC
GTCGTATGCAC -> TCGTATGCACC
TCGTATGCACC -> CGTATGCACCC
CGTATGCACCC -> GTATGCACCCT
GTATGCACCCT -> TATGCACCCTT
TATGCACCCTT -> ATGCACCCTTG
ATGCACCCTTG -> TGCACCCTTGC
TGCACCCTTGC -> GCACCCTTGCT
GCACCCTTGCT -> CACCCTTGCTA
CACCCTTGCTA -> ACCCTTGCTAC
ACCCTTGCTAC -> CCCTTGCTACC
CCCTTGCTACC -> CCTTGCTACCT
CCTTGCTACCT -> CTTGCTACCTA
CTTGCTACCTA -> TTGCTACCTAG
TTGCTACCTAG -> TGCTACCTAGG
TGCTACCTAGG -> GCTACCTAGGT
GCTACCTAGGT -> CTACCTAGGTC
CTACCTAGGTC -> TACCTAGGTCA
TACCTAGGTCA -> ACCTAGGTCAG
ACCTAGGTCAG -> CCTAGGTCAGA
CCTAGGTCAGA -> CTAGGTCAGAT
CTAGGTCAGAT -> TAGGTCAGATC
TAGGTCAGATC -> AGGTCAGATCA
AGGTCAGATCA -> GGTCAGATCAT
GGTCAGATCAT -> GTCAGATCATA
GTCAGATCATA -> TCAGATCATAC
TCAGATCATAC -> CAGATCATACC
CAGATCATACC -> AGATCATACCA
AGATCATACCA -> GATCATACCAT
GATCATACCAT -> ATCATACCATA
ATCATACCATA -> TCATACCATAT
TCATACCATAT -> CATACCATATG
CATACCATATG -> ATACCATATGC
ATACCATATGC -> TACCATATGCT
TACCATATGCT -> ACCATATGCTT
ACCATATGCTT -> CCATATGCTTT
CCATATGCTTT -> CATATGCTTTA
CATATGCTTTA -> ATATGCTTTAT
ATATGCTTTAT -> TATGCTTTATG
TATGCTTTATG -> ATGCTTTATGT
ATGCTTTATGT -> TGCTTTATGTC
TGCTTTATGTC -> GCTTTATGTCT
GCTTTATGTCT -> CTTTATGTCTT
CTTTATGTCTT -> TTTATGTCTTG
TTTATGTCTTG -> TTATGTCTTGT
TTATGTCTTGT -> TATGTCTTGTG
TATGTCTTGTG -> ATGTCTTGTGT
ATGTCTTGTGT -> TGTCTTGTGTA
TGTCTTGTGTA -> GTCTTGTGTAT
GTCTTGTGTAT -> TCTTGTGTATG
TCTTGTGTATG -> CTTGTGTATGT
CTTGTGTATGT -> TTGTGTATGTA
TTGTGTATGTA -> TGTGTATGTAG
TGTGTATGTAG -> GTGTATGTAGA
GTGTATGTAGA -> TGTATGTAGAA
TGTATGTAGAA -> GTATGTAGAAC
GTATGTAGAAC -> TATGTAGAACA
TATGTAGAACA -> ATGTAGAACAT
ATGTAGAACAT -> TGTAGAACATT
TGTAGAACATT -> GTAGAACATTA
GTAGAACATTA -> TAGAACATTAG
TAGAACATTAG -> AGAACATTAGA
AGAACATTAGA -> GAACATTAGAT
GAACATTAGAT -> AACATTAGATA
AACATTAGATA -> ACATTAGATAC
ACATTAGATAC -> CATTAGATACG
CATTAGATACG -> ATTAGATACGG
ATTAGATACGG -> TTAGATACGGT
TTAGATACGGT -> TAGATACGGTG
TAGATACGGTG -> AGATACGGTGG
AGATACGGTGG -> GATACGGTGGC
GATACGGTGGC -> ATACGGTGGCT
ATACGGTGGCT -> TACGGTGGCTG
TACGGTGGCTG -> ACGGTGGCTGG
ACGGTGGCTGG -> CGGTGGCTGGA
CGGTGGCTGGA -> GGTGGCTGGAC
GGTGGCTGGAC -> GTGGCTGGACC
GTGGCTGGACC -> TGGCTGGACCA
TGGCTGGACCA -> GGCTGGACCAT
GGCTGGACCAT -> GCTGGACCATC
GCTGGACCATC -> CTGGACCATCG
CTGGACCATCG -> TGGACCATCGC
TGGACCATCGC -> GGACCATCGCC
GGACCATCGCC -> GACCATCGCCA
GACCATCGCCA -> ACCATCGCCAA
ACCATCGCCAA -> CCATCGCCAAC
CCATCGCCAAC -> CATCGCCAACG
CATCGCCAACG -> ATCGCCAACGC
ATCGCCAACGC -> TCGCCAACGCT
TCGCCAACGCT -> CGCCAACGCTA
CGCCAACGCTA -> GCCAACGCTAG
GCCAACGCTAG -> CCAACGCTAGC
CCAACGCTAGC -> CAACGCTAGCA
CAACGCTAGCA -> AACGCTAGCAT
AACGCTAGCAT -> ACGCTAGCATT
ACGCTAGCATT -> CGCTAGCATTG
CGCTAGCATTG -> GCTAGCATTGG
GCTAGCATTGG -> CTAGCATTGGC
CTAGCATTGGC -> TAGCATTGGCA
TAGCATTGGCA -> AGCATTGGCAA
AGCATTGGCAA -> GCATTGGCAAT
GCATTGGCAAT -> CATTGGCAATG
CATTGGCAATG -> ATTGGCAATGT
ATTGGCAATGT -> TTGGCAATGTA
TTGGCAATGTA -> TGGCAATGTAC
TGGCAATGTAC -> GGCAATGTACA
GGCAATGTACA -> GCAATGTACAT
GCAATGTACAT -> CAATGTACATT
CAATGTACATT -> AATGTACATTA
AATGTACATTA -> ATGTACATTAA
ATGTACATTAA -> TGTACATTAAA
TGTACATTAAA -> GTACATTAAAT
GTACATTAAAT -> TACATTAAATC
TACATTAAATC -> ACATTAAATCG
ACATTAAATCG -> CATTAAATCGG
CATTAAATCGG -> ATTAAATCGGT
ATTAAATCGGT -> TTAAATCGGTT
TTAAATCGGTT -> TAAATCGGTTG
TAAATCGGTTG -> AAATCGGTTGG
AAATCGGTTGG -> AATCGGTTGGG
AATCGGTTGGG -> ATCGGTTGGGG
ATCGGTTGGGG -> TCGGTTGGGGC
TCGGTTGGGGC -> CGGTTGGGGCA
CGGTTGGGGCA -> GGTTGGGGCAA
GGTTGGGGCAA -> GTTGGGGCAAT
GTTGGGGCAAT -> TTGGGGCAATC
TTGGGGCAATC -> TGGGGCAATCA
TGGGGCAATCA -> GGGGCAATCAT
GGGGCAATCAT -> GGGCAATCATA
GGGCAATCATA -> GGCAATCATAT
GGCAATCATAT -> GCAATCATATC
GCAATCATATC -> CAATCATATCG
CAATCATATCG -> AATCATATCGC
AATCATATCGC -> ATCATATCGCA
ATCATATCGCA -> TCATATCGCAA
TCATATCGCAA -> CATATCGCAAT
CATATCGCAAT -> ATATCGCAATC
ATATCGCAATC -> TATCGCAATCC
TATCGCAATCC -> ATCGCAATCCG
ATCGCAATCCG -> TCGCAATCCGT
TCGCAATCCGT -> CGCAATCCGTC
CGCAATCCGTC -> GCAATCCGTCG
GCAATCCGTCG -> CAATCCGTCGC
CAATCCGTCGC -> AATCCGTCGCC
AATCCGTCGCC -> ATCCGTCGCCT
ATCCGTCGCCT -> TCCGTCGCCTT
TCCGTCGCCTT -> CCGTCGCCTTA
CCGTCGCCTTA -> CGTCGCCTTAT
CGTCGCCTTAT -> GTCGCCTTATC
GTCGCCTTATC -> TCGCCTTATCG
TCGCCTTATCG -> CGCCTTATCGT
CGCCTTATCGT -> GCCTTATCGTT
GCCTTATCGTT -> CCTTATCGTTT
CCTTATCGTTT -> CTTATCGTTTT
CTTATCGTTTT -> TTATCGTTTTT
TTATCGTTTTT -> TATCGTTTTTC
TATCGTTTTTC -> ATCGTTTTTCC
ATCGTTTTTCC -> TCGTTTTTCCA
TCGTTTTTCCA -> CGTTTTTCCAG
CGTTTTTCCAG -> GTTTTTCCAGA
GTTTTTCCAGA -> TTTTTCCAGAA
TTTTTCCAGAA -> TTTTCCAGAAA
TTTTCCAGAAA -> TTTCCAGAAAT
TTTCCAGAAAT -> TTCCAGAAATC
TTCCAGAAATC -> TCCAGAAATCT
TCCAGAAATCT -> CCAGAAATCTA
CCAGAAATCTA -> CAGAAATCTAG
CAGAAATCTAG -> AGAAATCTAGG
AGAAATCTAGG -> GAAATCTAGGT
GAAATCTAGGT -> AAATCTAGGTG
AAATCTAGGTG -> AATCTAGGTGC
AATCTAGGTGC -> ATCTAGGTGCC
ATCTAGGTGCC -> TCTAGGTGCCG
TCTAGGTGCCG -> CTAGGTGCCGC
CTAGGTGCCGC -> TAGGTGCCGCT
TAGGTGCCGCT -> AGGTGCCGCTA
AGGTGCCGCTA -> GGTGCCGCTAA
GGTGCCGCTAA -> GTGCCGCTAAC
GTGCCGCTAAC -> TGCCGCTAACC
TGCCGCTAACC -> GCCGCTAACCG
GCCGCTAACCG -> CCGCTAACCGC
CCGCTAACCGC -> CGCTAACCGCA
CGCTAACCGCA -> GCTAACCGCAA
GCTAACCGCAA -> CTAACCGCAAT
CTAACCGCAAT -> TAACCGCAATA
TAACCGCAATA -> AACCGCAATAT
AACCGCAATAT -> ACCGCAATATA
ACCGCAATATA -> CCGCAATATAG
CCGCAATATAG -> CGCAATATAGA
CGCAATATAGA -> GCAATATAGAC
GCAATATAGAC -> CAATATAGACC
CAATATAGACC -> AATATAGACCA
AATATAGACCA -> ATATAGACCAA
ATATAGACCAA -> TATAGACCAAT
TATAGACCAAT -> ATAGACCAATT
ATAGACCAATT -> TAGACCAATTA
TAGACCAATTA -> AGACCAATTAG
AGACCAATTAG -> GACCAATTAGA
GACCAATTAGA -> ACCAATTAGAA
ACCAATTAGAA -> CCAATTAGAAT
CCAATTAGAAT -> CAATTAGAATA
CAATTAGAATA -> AATTAGAATAC
AATTAGAATAC -> ATTAGAATACG
ATTAGAATACG -> TTAGAATACGC
TTAGAATACGC -> TAGAATACGCC
TAGAATACGCC -> AGAATACGCCC
AGAATACGCCC -> GAATACGCCCG
GAATACGCCCG -> AATACGCCCGG
AATACGCCCGG -> ATACGCCCGGC
ATACGCCCGGC -> TACGCCCGGCG
TACGCCCGGCG -> ACGCCCGGCGG
ACGCCCGGCGG -> CGCCCGGCGGG
CGCCCGGCGGG -> GCCCGGCGGGG
GCCCGGCGGGG -> CCCGGCGGGGA
CCCGGCGGGGA -> CCGGCGGGGAT
CCGGCGGGGAT -> CGGCGGGGATC
CGGCGGGGATC -> GGCGGGGATCC
GGCGGGGATCC -> GCGGGGATCCA
GCGGGGATCCA -> CGGGGATCCAC
CGGGGATCCAC -> GGGGATCCACA
GGGGATCCACA -> GGGATCCACAC
GGGATCCACAC -> GGATCCACACG
GGATCCACACG -> GATCCACACGC
GATCCACACGC -> ATCCACACGCG
ATCCACACGCG -> TCCACACGCGC
TCCACACGCGC -> CCACACGCGCG
CCACACGCGCG -> CACACGCGCGG
CACACGCGCGG -> ACACGCGCGGG
ACACGCGCGGG -> CACGCGCGGGG
CACGCGCGGGG -> ACGCGCGGGGT
ACGCGCGGGGT -> CGCGCGGGGTG
CGCGCGGGGTG -> GCGCGGGGTGA
GCGCGGGGTGA -> CGCGGGGTGAA
CGCGGGGTGAA -> GCGGGGTGAAG
GCGGGGTGAAG -> CGGGGTGAAGC
CGGGGTGAAGC -> GGGGTGAAGCT
GGGGTGAAGCT -> GGGTGAAGCTC
GGGTGAAGCTC -> GGTGAAGCTCA
GGTGAAGCTCA -> GTGAAGCTCAT
GTGAAGCTCAT -> TGAAGCTCATT
TGAAGCTCATT -> GAAGCTCATTG
GAAGCTCATTG -> AAGCTCATTGA
AAGCTCATTGA -> AGCTCATTGAC
AGCTCATTGAC -> GCTCATTGACT
GCTCATTGACT -> CTCATTGACTT
CTCATTGACTT -> TCATTGACTTC
TCATTGACTTC -> CATTGACTTCA
CATTGACTTCA -> ATTGACTTCAC
ATTGACTTCAC -> TTGACTTCACG
TTGACTTCACG -> TGACTTCACGT
TGACTTCACGT -> GACTTCACGTT
GACTTCACGTT -> ACTTCACGTTT
ACTTCACGTTT -> CTTCACGTTTG
CTTCACGTTTG -> TTCACGTTTGA
TTCACGTTTGA -> TCACGTTTGAC
TCACGTTTGAC -> CACGTTTGACT
CACGTTTGACT -> ACGTTTGACTT
ACGTTTGACTT -> CGTTTGACTTT
CGTTTGACTTT -> GTTTGACTTTC
GTTTGACTTTC -> TTTGACTTTCC
TTTGACTTTCC -> TTGACTTTCCG
TTGACTTTCCG -> TGACTTTCCGC
TGACTTTCCGC -> GACTTTCCGCG
GACTTTCCGCG -> ACTTTCCGCGA
ACTTTCCGCGA -> CTTTCCGCGAA
CTTTCCGCGAA -> TTTCCGCGAAG
TTTCCGCGAAG -> TTCCGCGAAGG
TTCCGCGAAGG -> TCCGCGAAGGC
TCCGCGAAGGC -> CCGCGAAGGCG
CCGCGAAGGCG -> CGCGAAGGCGA
CGCGAAGGCGA -> GCGAAGGCGAT
GCGAAGGCGAT -> CGAAGGCGATT
CGAAGGCGATT -> GAAGGCGATTG
GAAGGCGATTG -> AAGGCGATTGA
AAGGCGATTGA -> AGGCGATTGAT
AGGCGATTGAT -> GGCGATTGATG
GGCGATTGATG -> GCGATTGATGC
GCGATTGATGC -> CGATTGATGCG
CGATTGATGCG -> GATTGATGCGG
GATTGATGCGG -> ATTGATGCGGA
ATTGATGCGGA -> TTGATGCGGAT
TTGATGCGGAT -> TGATGCGGATC
TGATGCGGATC -> GATGCGGATCC
GATGCGGATCC -> ATGCGGATCCC
ATGCGGATCCC -> TGCGGATCCCT
TGCGGATCCCT -> GCGGATCCCTC
GCGGATCCCTC -> CGGATCCCTCC
CGGATCCCTCC -> GGATCCCTCCC
GGATCCCTCCC -> GATCCCTCCCC
GATCCCTCCCC -> ATCCCTCCCCC
ATCCCTCCCCC -> TCCCTCCCCCA
TCCCTCCCCCA -> CCCTCCCCCAT
CCCTCCCCCAT -> CCTCCCCCATG
CCTCCCCCATG -> CTCCCCCATGT
CTCCCCCATGT -> TCCCCCATGTA
TCCCCCATGTA -> CCCCCATGTAT
CCCCCATGTAT -> CCCCATGTATT
CCCCATGTATT -> CCCATGTATTT
CCCATGTATTT -> CCATGTATTTG
CCATGTATTTG -> CATGTATTTGC
CATGTATTTGC -> ATGTATTTGCC
ATGTATTTGCC -> TGTATTTGCCC
TGTATTTGCCC -> GTATTTGCCCA
GTATTTGCCCA -> TATTTGCCCAT
TATTTGCCCAT -> ATTTGCCCATG
ATTTGCCCATG -> TTTGCCCATGA
TTTGCCCATGA -> TTGCCCATGAC
TTGCCCATGAC -> TGCCCATGACG
TGCCCATGACG -> GCCCATGACGC
GCCCATGACGC -> CCCATGACGCA
CCCATGACGCA -> CCATGACGCAA
CCATGACGCAA -> CATGACGCAAC
CATGACGCAAC -> ATGACGCAACG
ATGACGCAACG -> TGACGCAACGA
TGACGCAACGA -> GACGCAACGAA
GACGCAACGAA -> ACGCAACGAAT
ACGCAACGAAT -> CGCAACGAATG
CGCAACGAATG -> GCAACGAATGA
GCAACGAATGA -> CAACGAATGAA
CAACGAATGAA -> AACGAATGAAC
AACGAATGAAC -> ACGAATGAACG
ACGAATGAACG -> CGAATGAACGA
CGAATGAACGA -> GAATGAACGAT
GAATGAACGAT -> AATGAACGATG
AATGAACGATG -> ATGAACGATGG
ATGAACGATGG -> TGAACGATGGG
TGAACGATGGG -> GAACGATGGGA
GAACGATGGGA -> AACGATGGGAC
AACGATGGGAC -> ACGATGGGACA
ACGATGGGACA -> CGATGGGACAA
CGATGGGACAA -> GATGGGACAAA
GATGGGACAAA -> ATGGGACAAAC
ATGGGACAAAC -> TGGGACAAACT
TGGGACAAACT -> GGGACAAACTG
GGGACAAACTG -> GGACAAACTGT
GGACAAACTGT -> GACAAACTGTC
GACAAACTGTC -> ACAAACTGTCT
ACAAACTGTCT -> CAAACTGTCTA
CAAACTGTCTA -> AAACTGTCTAT
AAACTGTCTAT -> AACTGTCTATG
AACTGTCTATG -> ACTGTCTATGT
ACTGTCTATGT -> CTGTCTATGTC
CTGTCTATGTC -> TGTCTATGTCG
TGTCTATGTCG -> GTCTATGTCGA
GTCTATGTCGA -> TCTATGTCGAG
TCTATGTCGAG -> CTATGTCGAGA
CTATGTCGAGA -> TATGTCGAGAG
TATGTCGAGAG -> ATGTCGAGAGC
ATGTCGAGAGC -> TGTCGAGAGCG
TGTCGAGAGCG -> GTCGAGAGCGC
GTCGAGAGCGC -> TCGAGAGCGCT
TCGAGAGCGCT -> CGAGAGCGCTA
CGAGAGCGCTA -> GAGAGCGCTAG
GAGAGCGCTAG -> AGAGCGCTAGA
AGAGCGCTAGA -> GAGCGCTAGAT
GAGCGCTAGAT -> AGCGCTAGATG
AGCGCTAGATG -> GCGCTAGATGA
GCGCTAGATGA -> CGCTAGATGAC
CGCTAGATGAC -> GCTAGATGACT
GCTAGATGACT -> CTAGATGACTG
CTAGATGACTG -> TAGATGACTGT
TAGATGACTGT -> AGATGACTGTA
AGATGACTGTA -> GATGACTGTAC
GATGACTGTAC -> ATGACTGTACC
ATGACTGTACC -> TGACTGTACCA
TGACTGTACCA -> GACTGTACCAT
GACTGTACCAT -> ACTGTACCATG
ACTGTACCATG -> CTGTACCATGA
CTGTACCATGA -> TGTACCATGAC
TGTACCATGAC -> GTACCATGACT
GTACCATGACT -> TACCATGACTC
TACCATGACTC -> ACCATGACTCC
ACCATGACTCC -> CCATGACTCCG
CCATGACTCCG -> CATGACTCCGC
CATGACTCCGC -> ATGACTCCGCG
ATGACTCCGCG -> TGACTCCGCGC
TGACTCCGCGC -> GACTCCGCGCG
GACTCCGCGCG -> ACTCCGCGCGT
ACTCCGCGCGT -> CTCCGCGCGTC
CTCCGCGCGTC -> TCCGCGCGTCG
TCCGCGCGTCG -> CCGCGCGTCGG
CCGCGCGTCGG -> CGCGCGTCGGG
CGCGCGTCGGG -> GCGCGTCGGGG
GCGCGTCGGGG -> CGCGTCGGGGG
CGCGTCGGGGG -> GCGTCGGGGGG
GCGTCGGGGGG -> CGTCGGGGGGA
CGTCGGGGGGA -> GTCGGGGGGAA
GTCGGGGGGAA -> TCGGGGGGAAA
TCGGGGGGAAA -> CGGGGGGAAAT
CGGGGGGAAAT -> GGGGGGAAATC
GGGGGGAAATC -> GGGGGAAATCC
GGGGGAAATCC -> GGGGAAATCCT
GGGGAAATCCT -> GGGAAATCCTT
GGGAAATCCTT -> GGAAATCCTTG
GGAAATCCTTG -> GAAATCCTTGG
GAAATCCTTGG -> AAATCCTTGGG
AAATCCTTGGG -> AATCCTTGGGA
AATCCTTGGGA -> ATCCTTGGGAA
ATCCTTGGGAA -> TCCTTGGGAAC
TCCTTGGGAAC -> CCTTGGGAACG
CCTTGGGAACG -> CTTGGGAACGC
CTTGGGAACGC -> TTGGGAACGCT
TTGGGAACGCT -> TGGGAACGCTT
TGGGAACGCTT -> GGGAACGCTTT
GGGAACGCTTT -> GGAACGCTTTT
GGAACGCTTTT -> GAACGCTTTTT
GAACGCTTTTT -> AACGCTTTTTG
AACGCTTTTTG -> ACGCTTTTTGA
ACGCTTTTTGA -> CGCTTTTTGAA
CGCTTTTTGAA -> GCTTTTTGAAT
GCTTTTTGAAT -> CTTTTTGAATA
CTTTTTGAATA -> TTTTTGAATAT
TTTTTGAATAT -> TTTTGAATATC
TTTTGAATATC -> TTTGAATATCT
TTTGAATATCT -> TTGAATATCTG
TTGAATATCTG -> TGAATATCTGA
TGAATATCTGA -> GAATATCTGAG
GAATATCTGAG -> AATATCTGAGC
AATATCTGAGC -> ATATCTGAGCT
ATATCTGAGCT -> TATCTGAGCTA
TATCTGAGCTA -> ATCTGAGCTAT
ATCTGAGCTAT -> TCTGAGCTATC
TCTGAGCTATC -> CTGAGCTATCA
CTGAGCTATCA -> TGAGCTATCAT
TGAGCTATCAT -> GAGCTATCATC
GAGCTATCATC -> AGCTATCATCA
AGCTATCATCA -> GCTATCATCAA
GCTATCATCAA -> CTATCATCAAG
CTATCATCAAG -> TATCATCAAGC
TATCATCAAGC -> ATCATCAAGCG
ATCATCAAGCG -> TCATCAAGCGG
TCATCAAGCGG -> CATCAAGCGGT
CATCAAGCGGT -> ATCAAGCGGTA
ATCAAGCGGTA -> TCAAGCGGTAT
TCAAGCGGTAT -> CAAGCGGTATC
CAAGCGGTATC -> AAGCGGTATCG
AAGCGGTATCG -> AGCGGTATCGA
AGCGGTATCGA -> GCGGTATCGAA
GCGGTATCGAA -> CGGTATCGAAA
CGGTATCGAAA -> GGTATCGAAAT
GGTATCGAAAT -> GTATCGAAATG
GTATCGAAATG -> TATCGAAATGC
TATCGAAATGC -> ATCGAAATGCC
ATCGAAATGCC -> TCGAAATGCCC
TCGAAATGCCC -> CGAAATGCCCG
CGAAATGCCCG -> GAAATGCCCGC
GAAATGCCCGC -> AAATGCCCGCA
AAATGCCCGCA -> AATGCCCGCAA
AATGCCCGCAA -> ATGCCCGCAAA
ATGCCCGCAAA -> TGCCCGCAAAG
TGCCCGCAAAG -> GCCCGCAAAGG
GCCCGCAAAGG -> CCCGCAAAGGT
CCCGCAAAGGT -> CCGCAAAGGTG
CCGCAAAGGTG -> CGCAAAGGTGC
CGCAAAGGTGC -> GCAAAGGTGCC
GCAAAGGTGCC -> CAAAGGTGCCT
CAAAGGTGCCT -> AAAGGTGCCTT
AAAGGTGCCTT -> AAGGTGCCTTC
AAGGTGCCTTC -> AGGTGCCTTCG
AGGTGCCTTCG -> GGTGCCTTCGA
GGTGCCTTCGA -> GTGCCTTCGAG
GTGCCTTCGAG -> TGCCTTCGAGA
TGCCTTCGAGA -> GCCTTCGAGAA
GCCTTCGAGAA -> CCTTCGAGAAG
CCTTCGAGAAG -> CTTCGAGAAGC
CTTCGAGAAGC -> TTCGAGAAGCA
TTCGAGAAGCA -> TCGAGAAGCAC
TCGAGAAGCAC -> CGAGAAGCACC
CGAGAAGCACC -> GAGAAGCACCC
GAGAAGCACCC -> AGAAGCACCCA
AGAAGCACCCA -> GAAGCACCCAG
GAAGCACCCAG -> AAGCACCCAGA
AAGCACCCAGA -> AGCACCCAGAC
AGCACCCAGAC -> GCACCCAGACG
GCACCCAGACG -> CACCCAGACGC
CACCCAGACGC -> ACCCAGACGCG
ACCCAGACGCG -> CCCAGACGCGC
CCCAGACGCGC -> CCAGACGCGCC
CCAGACGCGCC -> CAGACGCGCCC
CAGACGCGCCC -> AGACGCGCCCT
AGACGCGCCCT -> GACGCGCCCTC
GACGCGCCCTC -> ACGCGCCCTCT
ACGCGCCCTCT -> CGCGCCCTCTG
CGCGCCCTCTG -> GCGCCCTCTGT
GCGCCCTCTGT -> CGCCCTCTGTA
CGCCCTCTGTA -> GCCCTCTGTAG
GCCCTCTGTAG -> CCCTCTGTAGC
CCCTCTGTAGC -> CCTCTGTAGCT
CCTCTGTAGCT -> CTCTGTAGCTA
CTCTGTAGCTA -> TCTGTAGCTAT
TCTGTAGCTAT -> CTGTAGCTATC
CTGTAGCTATC -> TGTAGCTATCT
TGTAGCTATCT -> GTAGCTATCTC
GTAGCTATCTC -> TAGCTATCTCT
TAGCTATCTCT -> AGCTATCTCTC
AGCTATCTCTC -> GCTATCTCTCC
GCTATCTCTCC -> CTATCTCTCCT
CTATCTCTCCT -> TATCTCTCCTA
TATCTCTCCTA -> ATCTCTCCTAT
ATCTCTCCTAT -> TCTCTCCTATG
TCTCTCCTATG -> CTCTCCTATGG
CTCTCCTATGG -> TCTCCTATGGT
TCTCCTATGGT -> CTCCTATGGTA
CTCCTATGGTA -> TCCTATGGTAC
TCCTATGGTAC -> CCTATGGTACA
CCTATGGTACA -> CTATGGTACAG
CTATGGTACAG -> TATGGTACAGC
TATGGTACAGC -> ATGGTACAGCG
ATGGTACAGCG -> TGGTACAGCGG
TGGTACAGCGG -> GGTACAGCGGT
GGTACAGCGGT -> GTACAGCGGTG
GTACAGCGGTG -> TACAGCGGTGC
TACAGCGGTGC -> ACAGCGGTGCG
ACAGCGGTGCG -> CAGCGGTGCGG
CAGCGGTGCGG -> AGCGGTGCGGC
AGCGGTGCGGC -> GCGGTGCGGCC
GCGGTGCGGCC -> CGGTGCGGCCC
CGGTGCGGCCC -> GGTGCGGCCCT
GGTGCGGCCCT -> GTGCGGCCCTC
GTGCGGCCCTC -> TGCGGCCCTCC
TGCGGCCCTCC -> GCGGCCCTCCG
GCGGCCCTCCG -> CGGCCCTCCGG
CGGCCCTCCGG -> GGCCCTCCGGC
GGCCCTCCGGC -> GCCCTCCGGCA
GCCCTCCGGCA -> CCCTCCGGCAT
CCCTCCGGCAT -> CCTCCGGCATC
CCTCCGGCATC -> CTCCGGCATCC
CTCCGGCATCC -> TCCGGCATCCA
TCCGGCATCCA -> CCGGCATCCAC
CCGGCATCCAC -> CGGCATCCACT
CGGCATCCACT -> GGCATCCACTC
GGCATCCACTC -> GCATCCACTCA
GCATCCACTCA -> CATCCACTCAT
CATCCACTCAT -> ATCCACTCATC
ATCCACTCATC -> TCCACTCATCC
TCCACTCATCC -> CCACTCATCCT
CCACTCATCCT -> CACTCATCCTG
CACTCATCCTG -> ACTCATCCTGG
ACTCATCCTGG -> CTCATCCTGGA
CTCATCCTGGA -> TCATCCTGGAA
TCATCCTGGAA -> CATCCTGGAAA
CATCCTGGAAA -> ATCCTGGAAAT
ATCCTGGAAAT -> TCCTGGAAATC
TCCTGGAAATC -> CCTGGAAATCC
CCTGGAAATCC -> CTGGAAATCCA
CTGGAAATCCA -> TGGAAATCCAA
TGGAAATCCAA -> GGAAATCCAAA
GGAAATCCAAA -> GAAATCCAAAA
GAAATCCAAAA -> AAATCCAAAAT
AAATCCAAAAT -> AATCCAAAATA
AATCCAAAATA -> ATCCAAAATAA
ATCCAAAATAA -> TCCAAAATAAG
TCCAAAATAAG -> CCAAAATAAGA
CCAAAATAAGA -> CAAAATAAGAC
CAAAATAAGAC -> AAAATAAGACT
AAAATAAGACT -> AAATAAGACTC
AAATAAGACTC -> AATAAGACTCC
AATAAGACTCC -> ATAAGACTCCG
ATAAGACTCCG -> TAAGACTCCGT
TAAGACTCCGT -> AAGACTCCGTC
AAGACTCCGTC -> AGACTCCGTCA
AGACTCCGTCA -> GACTCCGTCAT
GACTCCGTCAT -> ACTCCGTCATG
ACTCCGTCATG -> CTCCGTCATGA
CTCCGTCATGA -> TCCGTCATGAG
TCCGTCATGAG -> CCGTCATGAGC
CCGTCATGAGC -> CGTCATGAGCT
CGTCATGAGCT -> GTCATGAGCTG
GTCATGAGCTG -> TCATGAGCTGC
TCATGAGCTGC -> CATGAGCTGCT
CATGAGCTGCT -> ATGAGCTGCTG
ATGAGCTGCTG -> TGAGCTGCTGA
TGAGCTGCTGA -> GAGCTGCTGAA
GAGCTGCTGAA -> AGCTGCTGAAC
AGCTGCTGAAC -> GCTGCTGAACC
GCTGCTGAACC -> CTGCTGAACCA
CTGCTGAACCA -> TGCTGAACCAA
TGCTGAACCAA -> GCTGAACCAAG
GCTGAACCAAG -> CTGAACCAAGA
CTGAACCAAGA -> TGAACCAAGAC
TGAACCAAGAC -> GAACCAAGACT
GAACCAAGACT -> AACCAAGACTT
AACCAAGACTT -> ACCAAGACTTT
ACCAAGACTTT -> CCAAGACTTTC
CCAAGACTTTC -> CAAGACTTTCT
CAAGACTTTCT -> AAGACTTTCTT
AAGACTTTCTT -> AGACTTTCTTT
AGACTTTCTTT -> GACTTTCTTTA
GACTTTCTTTA -> ACTTTCTTTAC
ACTTTCTTTAC -> CTTTCTTTACC
CTTTCTTTACC -> TTTCTTTACCT
TTTCTTTACCT -> TTCTTTACCTC
TTCTTTACCTC -> TCTTTACCTCC
TCTTTACCTCC -> CTTTACCTCCC
CTTTACCTCCC -> TTTACCTCCCT
TTTACCTCCCT -> TTACCTCCCTC
TTACCTCCCTC -> TACCTCCCTCA
TACCTCCCTCA -> ACCTCCCTCAG
ACCTCCCTCAG -> CCTCCCTCAGT
CCTCCCTCAGT -> CTCCCTCAGTT
CTCCCTCAGTT -> TCCCTCAGTTG
TCCCTCAGTTG -> CCCTCAGTTGA
CCCTCAGTTGA -> CCTCAGTTGAG
CCTCAGTTGAG -> CTCAGTTGAGC
CTCAGTTGAGC -> TCAGTTGAGCA
TCAGTTGAGCA -> CAGTTGAGCAT
CAGTTGAGCAT -> AGTTGAGCATT
AGTTGAGCATT -> GTTGAGCATTG
GTTGAGCATTG -> TTGAGCATTGC
TTGAGCATTGC -> TGAGCATTGCG
TGAGCATTGCG -> GAGCATTGCGA
GAGCATTGCGA -> AGCATTGCGAC
AGCATTGCGAC -> GCATTGCGACG
GCATTGCGACG -> CATTGCGACGA
CATTGCGACGA -> ATTGCGACGAG
ATTGCGACGAG -> TTGCGACGAGT
TTGCGACGAGT -> TGCGACGAGTG
TGCGACGAGTG -> GCGACGAGTGC
GCGACGAGTGC -> CGACGAGTGCA
CGACGAGTGCA -> GACGAGTGCAA
GACGAGTGCAA -> ACGAGTGCAAG
ACGAGTGCAAG -> CGAGTGCAAGC
CGAGTGCAAGC -> GAGTGCAAGCA
GAGTGCAAGCA -> AGTGCAAGCAG
AGTGCAAGCAG -> GTGCAAGCAGG
GTGCAAGCAGG -> TGCAAGCAGGG
TGCAAGCAGGG -> GCAAGCAGGGT
GCAAGCAGGGT -> CAAGCAGGGTC
CAAGCAGGGTC -> AAGCAGGGTCA
AAGCAGGGTCA -> AGCAGGGTCAT
AGCAGGGTCAT -> GCAGGGTCATG
GCAGGGTCATG -> CAGGGTCATGT
CAGGGTCATGT -> AGGGTCATGTT
AGGGTCATGTT -> GGGTCATGTTC
GGGTCATGTTC -> GGTCATGTTCT
GGTCATGTTCT -> GTCATGTTCTT
GTCATGTTCTT -> TCATGTTCTTC
TCATGTTCTTC -> CATGTTCTTCA
CATGTTCTTCA -> ATGTTCTTCAA
ATGTTCTTCAA -> TGTTCTTCAAC
TGTTCTTCAAC -> GTTCTTCAACC
GTTCTTCAACC -> TTCTTCAACCA
TTCTTCAACCA -> TCTTCAACCAT
TCTTCAACCAT -> CTTCAACCATA
CTTCAACCATA -> TTCAACCATAA
TTCAACCATAA -> TCAACCATAAA
TCAACCATAAA -> CAACCATAAAT
CAACCATAAAT -> AACCATAAATG
AACCATAAATG -> ACCATAAATGA
ACCATAAATGA -> CCATAAATGAC
CCATAAATGAC -> CATAAATGACC
CATAAATGACC -> ATAAATGACCC
ATAAATGACCC -> TAAATGACCCG
TAAATGACCCG -> AAATGACCCGT
AAATGACCCGT -> AATGACCCGTT
AATGACCCGTT -> ATGACCCGTTG
ATGACCCGTTG -> TGACCCGTTGC
TGACCCGTTGC -> GACCCGTTGCA
GACCCGTTGCA -> ACCCGTTGCAA
ACCCGTTGCAA -> CCCGTTGCAAG
CCCGTTGCAAG -> CCGTTGCAAGA
CCGTTGCAAGA -> CGTTGCAAGAC
CGTTGCAAGAC -> GTTGCAAGACA
GTTGCAAGACA -> TTGCAAGACAT
TTGCAAGACAT -> TGCAAGACATG
TGCAAGACATG -> GCAAGACATGG
GCAAGACATGG -> CAAGACATGGC
CAAGACATGGC -> AAGACATGGCA
AAGACATGGCA -> AGACATGGCAG
AGACATGGCAG -> GACATGGCAGT
GACATGGCAGT -> ACATGGCAGTG
ACATGGCAGTG -> CATGGCAGTGT
CATGGCAGTGT -> ATGGCAGTGTT
ATGGCAGTGTT -> TGGCAGTGTTC
TGGCAGTGTTC -> GGCAGTGTTCT
GGCAGTGTTCT -> GCAGTGTTCTT
GCAGTGTTCTT -> CAGTGTTCTTG
CAGTGTTCTTG -> AGTGTTCTTGT
AGTGTTCTTGT -> GTGTTCTTGTT
GTGTTCTTGTT -> TGTTCTTGTTC
TGTTCTTGTTC -> GTTCTTGTTCG
GTTCTTGTTCG -> TTCTTGTTCGA
TTCTTGTTCGA -> TCTTGTTCGAG
TCTTGTTCGAG -> CTTGTTCGAGC
CTTGTTCGAGC -> TTGTTCGAGCA
TTGTTCGAGCA -> TGTTCGAGCAC
TGTTCGAGCAC -> GTTCGAGCACT
GTTCGAGCACT -> TTCGAGCACTG
TTCGAGCACTG -> TCGAGCACTGG
TCGAGCACTGG -> CGAGCACTGGC
CGAGCACTGGC -> GAGCACTGGCC
GAGCACTGGCC -> AGCACTGGCCC
AGCACTGGCCC -> GCACTGGCCCC
GCACTGGCCCC -> CACTGGCCCCA
CACTGGCCCCA -> ACTGGCCCCAC
ACTGGCCCCAC -> CTGGCCCCACA
CTGGCCCCACA -> TGGCCCCACAC
TGGCCCCACAC -> GGCCCCACACG
GGCCCCACACG -> GCCCCACACGT
GCCCCACACGT -> CCCCACACGTC
CCCCACACGTC -> CCCACACGTCG
CCCACACGTCG -> CCACACGTCGA
CCACACGTCGA -> CACACGTCGAT
CACACGTCGAT -> ACACGTCGATG
ACACGTCGATG -> CACGTCGATGA
CACGTCGATGA -> ACGTCGATGAC
ACGTCGATGAC -> CGTCGATGACG
CGTCGATGACG -> GTCGATGACGG
GTCGATGACGG -> TCGATGACGGT
TCGATGACGGT -> CGATGACGGTT
CGATGACGGTT -> GATGACGGTTA
GATGACGGTTA -> ATGACGGTTAT
ATGACGGTTAT -> TGACGGTTATT
TGACGGTTATT -> GACGGTTATTC
GACGGTTATTC -> ACGGTTATTCA
ACGGTTATTCA -> CGGTTATTCAG
CGGTTATTCAG -> GGTTATTCAGA
GGTTATTCAGA -> GTTATTCAGAG
GTTATTCAGAG -> TTATTCAGAGG
TTATTCAGAGG -> TATTCAGAGGT
TATTCAGAGGT -> ATTCAGAGGTG
ATTCAGAGGTG -> TTCAGAGGTGC
TTCAGAGGTGC -> TCAGAGGTGCT
TCAGAGGTGCT -> CAGAGGTGCTG
CAGAGGTGCTG -> AGAGGTGCTGA
AGAGGTGCTGA -> GAGGTGCTGAG
GAGGTGCTGAG -> AGGTGCTGAGG
AGGTGCTGAGG -> GGTGCTGAGGT
GGTGCTGAGGT -> GTGCTGAGGTT
GTGCTGAGGTT -> TGCTGAGGTTG
TGCTGAGGTTG -> GCTGAGGTTGT
GCTGAGGTTGT -> CTGAGGTTGTG
CTGAGGTTGTG -> TGAGGTTGTGC
TGAGGTTGTGC -> GAGGTTGTGCT
GAGGTTGTGCT -> AGGTTGTGCTT
AGGTTGTGCTT -> GGTTGTGCTTT
GGTTGTGCTTT -> GTTGTGCTTTT
GTTGTGCTTTT -> TTGTGCTTTTT
TTGTGCTTTTT -> TGTGCTTTTTT
TGTGCTTTTTT -> GTGCTTTTTTG
GTGCTTTTTTG -> TGCTTTTTTGC
TGCTTTTTTGC -> GCTTTTTTGCG
GCTTTTTTGCG -> CTTTTTTGCGA
CTTTTTTGCGA -> TTTTTTGCGAG
TTTTTTGCGAG -> TTTTTGCGAGG
TTTTTGCGAGG -> TTTTGCGAGGT
TTTTGCGAGGT -> TTTGCGAGGTT
TTTGCGAGGTT -> TTGCGAGGTTA
TTGCGAGGTTA -> TGCGAGGTTAG
TGCGAGGTTAG -> GCGAGGTTAGT
GCGAGGTTAGT -> CGAGGTTAGTC
CGAGGTTAGTC -> GAGGTTAGTCC
GAGGTTAGTCC -> AGGTTAGTCCT
AGGTTAGTCCT -> GGTTAGTCCTA
GGTTAGTCCTA -> GTTAGTCCTAC
GTTAGTCCTAC -> TTAGTCCTACA
TTAGTCCTACA -> TAGTCCTACAG
TAGTCCTACAG -> AGTCCTACAGT
AGTCCTACAGT -> GTCCTACAGTA
GTCCTACAGTA -> TCCTACAGTAA
TCCTACAGTAA -> CCTACAGTAAG
CCTACAGTAAG -> CTACAGTAAGC
CTACAGTAAGC -> TACAGTAAGCC
TACAGTAAGCC -> ACAGTAAGCCG
ACAGTAAGCCG -> CAGTAAGCCGA
CAGTAAGCCGA -> AGTAAGCCGAA
AGTAAGCCGAA -> GTAAGCCGAAA
GTAAGCCGAAA -> TAAGCCGAAAC
TAAGCCGAAAC -> AAGCCGAAACC
AAGCCGAAACC -> AGCCGAAACCC
AGCCGAAACCC -> GCCGAAACCCT
GCCGAAACCCT -> CCGAAACCCTC
CCGAAACCCTC -> CGAAACCCTCT
CGAAACCCTCT -> GAAACCCTCTA
GAAACCCTCTA -> AAACCCTCTAT
AAACCCTCTAT -> AACCCTCTATG
AACCCTCTATG -> ACCCTCTATGA
ACCCTCTATGA -> CCCTCTATGAC
CCCTCTATGAC -> CCTCTATGACG
CCTCTATGACG -> CTCTATGACGT
CTCTATGACGT -> TCTATGACGTA
TCTATGACGTA -> CTATGACGTAC
CTATGACGTAC -> TATGACGTACT
TATGACGTACT -> ATGACGTACTC
ATGACGTACTC -> TGACGTACTCC
TGACGTACTCC -> GACGTACTCCG
GACGTACTCCG -> ACGTACTCCGA
ACGTACTCCGA -> CGTACTCCGAC
CGTACTCCGAC -> GTACTCCGACG
GTACTCCGACG -> TACTCCGACGC
TACTCCGACGC -> ACTCCGACGCG
ACTCCGACGCG -> CTCCGACGCGA
CTCCGACGCGA -> TCCGACGCGAC
TCCGACGCGAC -> CCGACGCGACG
CCGACGCGACG -> CGACGCGACGT
CGACGCGACGT -> GACGCGACGTA
GACGCGACGTA -> ACGCGACGTAT
ACGCGACGTAT -> CGCGACGTATT
CGCGACGTATT -> GCGACGTATTC
GCGACGTATTC -> CGACGTATTCT
CGACGTATTCT -> GACGTATTCTT
GACGTATTCTT -> ACGTATTCTTG
ACGTATTCTTG -> CGTATTCTTGC
CGTATTCTTGC -> GTATTCTTGCT
GTATTCTTGCT -> TATTCTTGCTT
TATTCTTGCTT -> ATTCTTGCTTT
ATTCTTGCTTT -> TTCTTGCTTTG
TTCTTGCTTTG -> TCTTGCTTTGT
TCTTGCTTTGT -> CTTGCTTTGTA
CTTGCTTTGTA -> TTGCTTTGTAT
TTGCTTTGTAT -> TGCTTTGTATC
TGCTTTGTATC -> GCTTTGTATCA
GCTTTGTATCA -> CTTTGTATCAC
CTTTGTATCAC -> TTTGTATCACG
TTTGTATCACG -> TTGTATCACGT
TTGTATCACGT -> TGTATCACGTG
TGTATCACGTG -> GTATCACGTGC
GTATCACGTGC -> TATCACGTGCT
TATCACGTGCT -> ATCACGTGCTA
ATCACGTGCTA -> TCACGTGCTAT
TCACGTGCTAT -> CACGTGCTATG
CACGTGCTATG -> ACGTGCTATGG
ACGTGCTATGG -> CGTGCTATGGG
CGTGCTATGGG -> GTGCTATGGGC
GTGCTATGGGC -> TGCTATGGGCC
TGCTATGGGCC -> GCTATGGGCCT
GCTATGGGCCT -> CTATGGGCCTT
CTATGGGCCTT -> TATGGGCCTTG
TATGGGCCTTG -> ATGGGCCTTGG
ATGGGCCTTGG -> TGGGCCTTGGA
TGGGCCTTGGA -> GGGCCTTGGAT
GGGCCTTGGAT -> GGCCTTGGATA
GGCCTTGGATA -> GCCTTGGATAC
GCCTTGGATAC -> CCTTGGATACC
CCTTGGATACC -> CTTGGATACCC
CTTGGATACCC -> TTGGATACCCA
TTGGATACCCA -> TGGATACCCAC
TGGATACCCAC -> GGATACCCACG
GGATACCCACG -> GATACCCACGT
GATACCCACGT -> ATACCCACGTA
ATACCCACGTA -> TACCCACGTAA
TACCCACGTAA -> ACCCACGTAAC, ACCCACGTAAT
ACCCACGTAAC -> CCCACGTAACT
CCCACGTAACT -> CCACGTAACTC
CCACGTAACTC -> CACGTAACTCC
CACGTAACTCC -> ACGTAACTCCA
ACGTAACTCCA -> CGTAACTCCAA
CGTAACTCCAA -> GTAACTCCAAA
GTAACTCCAAA -> TAACTCCAAAG
TAACTCCAAAG -> AACTCCAAAGG
AACTCCAAAGG -> ACTCCAAAGGT
ACTCCAAAGGT -> CTCCAAAGGTG
CTCCAAAGGTG -> TCCAAAGGTGC
TCCAAAGGTGC -> CCAAAGGTGCT
CCAAAGGTGCT -> CAAAGGTGCTC
CAAAGGTGCTC -> AAAGGTGCTCT
AAAGGTGCTCT -> AAGGTGCTCTG
AAGGTGCTCTG -> AGGTGCTCTGA
AGGTGCTCTGA -> GGTGCTCTGAC
GGTGCTCTGAC -> GTGCTCTGACA
GTGCTCTGACA -> TGCTCTGACAT
TGCTCTGACAT -> GCTCTGACATA
GCTCTGACATA -> CTCTGACATAT
CTCTGACATAT -> TCTGACATATG
TCTGACATATG -> CTGACATATGT
CTGACATATGT -> TGACATATGTA
TGACATATGTA -> GACATATGTAA
GACATATGTAA -> ACATATGTAAC
ACATATGTAAC -> CATATGTAACT
CATATGTAACT -> ATATGTAACTT
ATATGTAACTT -> TATGTAACTTT
TATGTAACTTT -> ATGTAACTTTG
ATGTAACTTTG -> TGTAACTTTGC
TGTAACTTTGC -> GTAACTTTGCA
GTAACTTTGCA -> TAACTTTGCAA
TAACTTTGCAA -> AACTTTGCAAT
AACTTTGCAAT -> ACTTTGCAATT
ACTTTGCAATT -> CTTTGCAATTC
CTTTGCAATTC -> TTTGCAATTCT
TTTGCAATTCT -> TTGCAATTCTG
TTGCAATTCTG -> TGCAATTCTGC
TGCAATTCTGC -> GCAATTCTGCA
GCAATTCTGCA -> CAATTCTGCAT
CAATTCTGCAT -> AATTCTGCATT
AATTCTGCATT -> ATTCTGCATTA
ATTCTGCATTA -> TTCTGCATTAG
TTCTGCATTAG -> TCTGCATTAGA
TCTGCATTAGA -> CTGCATTAGAA
CTGCATTAGAA -> TGCATTAGAAT
TGCATTAGAAT -> GCATTAGAATC
GCATTAGAATC -> CATTAGAATCT
CATTAGAATCT -> ATTAGAATCTA
ATTAGAATCTA -> TTAGAATCTAC
TTAGAATCTAC -> TAGAATCTACA
TAGAATCTACA -> AGAATCTACAA
AGAATCTACAA -> GAATCTACAAG
GAATCTACAAG -> AATCTACAAGG
AATCTACAAGG -> ATCTACAAGGG
ATCTACAAGGG -> TCTACAAGGGA
TCTACAAGGGA -> CTACAAGGGAC
CTACAAGGGAC -> TACAAGGGACG
TACAAGGGACG -> ACAAGGGACGG
ACAAGGGACGG -> CAAGGGACGGG
CAAGGGACGGG -> AAGGGACGGGC
AAGGGACGGGC -> AGGGACGGGCG
AGGGACGGGCG -> GGGACGGGCGT
GGGACGGGCGT -> GGACGGGCGTC
GGACGGGCGTC -> GACGGGCGTCT
GACGGGCGTCT -> ACGGGCGTCTG
ACGGGCGTCTG -> CGGGCGTCTGC
CGGGCGTCTGC -> GGGCGTCTGCG
GGGCGTCTGCG -> GGCGTCTGCGT
GGCGTCTGCGT -> GCGTCTGCGTG
GCGTCTGCGTG -> CGTCTGCGTGA
CGTCTGCGTGA -> GTCTGCGTGAC
GTCTGCGTGAC -> TCTGCGTGACG
TCTGCGTGACG -> CTGCGTGACGC
CTGCGTGACGC -> TGCGTGACGCA
TGCGTGACGCA -> GCGTGACGCAC
GCGTGACGCAC -> CGTGACGCACG
CGTGACGCACG -> GTGACGCACGC
GTGACGCACGC -> TGACGCACGCC
TGACGCACGCC -> GACGCACGCCA
GACGCACGCCA -> ACGCACGCCAG
ACGCACGCCAG -> CGCACGCCAGC
CGCACGCCAGC -> GCACGCCAGCG
GCACGCCAGCG -> CACGCCAGCGT
CACGCCAGCGT -> ACGCCAGCGTT
ACGCCAGCGTT -> CGCCAGCGTTA
CGCCAGCGTTA -> GCCAGCGTTAA
GCCAGCGTTAA -> CCAGCGTTAAC
CCAGCGTTAAC -> CAGCGTTAACT
CAGCGTTAACT -> AGCGTTAACTT
AGCGTTAACTT -> GCGTTAACTTT
GCGTTAACTTT -> CGTTAACTTTC
CGTTAACTTTC -> GTTAACTTTCC
GTTAACTTTCC -> TTAACTTTCCA
TTAACTTTCCA -> TAACTTTCCAC
TAACTTTCCAC -> AACTTTCCACT
AACTTTCCACT -> ACTTTCCACTA
ACTTTCCACTA -> CTTTCCACTAC
CTTTCCACTAC -> TTTCCACTACG
TTTCCACTACG -> TTCCACTACGA
TTCCACTACGA -> TCCACTACGAC
TCCACTACGAC -> CCACTACGACA
CCACTACGACA -> CACTACGACAA
CACTACGACAA -> ACTACGACAAG
ACTACGACAAG -> CTACGACAAGA
CTACGACAAGA -> TACGACAAGAG
TACGACAAGAG -> ACGACAAGAGT
ACGACAAGAGT -> CGACAAGAGTT
CGACAAGAGTT -> GACAAGAGTTT
GACAAGAGTTT -> ACAAGAGTTTA
ACAAGAGTTTA -> CAAGAGTTTAG
CAAGAGTTTAG -> AAGAGTTTAGT
AAGAGTTTAGT -> AGAGTTTAGTG
AGAGTTTAGTG -> GAGTTTAGTGG
GAGTTTAGTGG -> AGTTTAGTGGA
AGTTTAGTGGA -> GTTTAGTGGAA
GTTTAGTGGAA -> TTTAGTGGAAT
TTTAGTGGAAT -> TTAGTGGAATG
TTAGTGGAATG -> TAGTGGAATGC
TAGTGGAATGC -> AGTGGAATGCC
AGTGGAATGCC -> GTGGAATGCCT
GTGGAATGCCT -> TGGAATGCCTT
TGGAATGCCTT -> GGAATGCCTTT
GGAATGCCTTT -> GAATGCCTTTC
GAATGCCTTTC -> AATGCCTTTCA
AATGCCTTTCA -> ATGCCTTTCAG
ATGCCTTTCAG -> TGCCTTTCAGA
TGCCTTTCAGA -> GCCTTTCAGAG
GCCTTTCAGAG -> CCTTTCAGAGA
CCTTTCAGAGA -> CTTTCAGAGAT
CTTTCAGAGAT -> TTTCAGAGATG
TTTCAGAGATG -> TTCAGAGATGT
TTCAGAGATGT -> TCAGAGATGTA
TCAGAGATGTA -> CAGAGATGTAT
CAGAGATGTAT -> AGAGATGTATT
AGAGATGTATT -> GAGATGTATTT
GAGATGTATTT -> AGATGTATTTG
AGATGTATTTG -> GATGTATTTGG
GATGTATTTGG -> ATGTATTTGGT
ATGTATTTGGT -> TGTATTTGGTC
TGTATTTGGTC -> GTATTTGGTCG
GTATTTGGTCG -> TATTTGGTCGT
TATTTGGTCGT -> ATTTGGTCGTG
ATTTGGTCGTG -> TTTGGTCGTGG
TTTGGTCGTGG -> TTGGTCGTGGA
TTGGTCGTGGA -> TGGTCGTGGAT
TGGTCGTGGAT -> GGTCGTGGATG
GGTCGTGGATG -> GTCGTGGATGT
GTCGTGGATGT -> TCGTGGATGTA
TCGTGGATGTA -> CGTGGATGTAC
CGTGGATGTAC -> GTGGATGTACT
GTGGATGTACT -> TGGATGTACTT
TGGATGTACTT -> GGATGTACTTT
GGATGTACTTT -> GATGTACTTTT
GATGTACTTTT -> ATGTACTTTTT
ATGTACTTTTT -> TGTACTTTTTT
TGTACTTTTTT -> GTACTTTTTTA
GTACTTTTTTA -> TACTTTTTTAG
TACTTTTTTAG -> ACTTTTTTAGA
ACTTTTTTAGA -> CTTTTTTAGAA
CTTTTTTAGAA -> TTTTTTAGAAT
TTTTTTAGAAT -> TTTTTAGAATG
TTTTTAGAATG -> TTTTAGAATGA
TTTTAGAATGA -> TTTAGAATGAA
TTTAGAATGAA -> TTAGAATGAAG
TTAGAATGAAG -> TAGAATGAAGT
TAGAATGAAGT -> AGAATGAAGTG
AGAATGAAGTG -> GAATGAAGTGT
GAATGAAGTGT -> AATGAAGTGTT
AATGAAGTGTT -> ATGAAGTGTTA
ATGAAGTGTTA -> TGAAGTGTTAC
TGAAGTGTTAC -> GAAGTGTTACG
GAAGTGTTACG -> AAGTGTTACGG
AAGTGTTACGG -> AGTGTTACGGA
AGTGTTACGGA -> GTGTTACGGAA
GTGTTACGGAA -> TGTTACGGAAA
TGTTACGGAAA -> GTTACGGAAAT
GTTACGGAAAT -> TTACGGAAATC
TTACGGAAATC -> TACGGAAATCT
TACGGAAATCT -> ACGGAAATCTA
ACGGAAATCTA -> CGGAAATCTAT
CGGAAATCTAT -> GGAAATCTATA
GGAAATCTATA -> GAAATCTATAC
GAAATCTATAC -> AAATCTATACT
AAATCTATACT -> AATCTATACTC
AATCTATACTC -> ATCTATACTCA
ATCTATACTCA -> TCTATACTCAC
TCTATACTCAC -> CTATACTCACT
CTATACTCACT -> TATACTCACTA
TATACTCACTA -> ATACTCACTAC
ATACTCACTAC -> TACTCACTACC
TACTCACTACC -> ACTCACTACCC
ACTCACTACCC -> CTCACTACCCA
CTCACTACCCA -> TCACTACCCAC
TCACTACCCAC -> CACTACCCACG
CACTACCCACG -> ACTACCCACGT
ACTACCCACGT -> CTACCCACGTA
CTACCCACGTA -> TACCCACGTAA
ACCCACGTAAT -> CCCACGTAATG
CCCACGTAATG -> CCACGTAATGG
CCACGTAATGG -> CACGTAATGGA
CACGTAATGGA -> ACGTAATGGAC
ACGTAATGGAC -> CGTAATGGACG
CGTAATGGACG -> GTAATGGACGA
GTAATGGACGA -> TAATGGACGAT
TAATGGACGAT -> AATGGACGATC
AATGGACGATC -> ATGGACGATCT
ATGGACGATCT -> TGGACGATCTG
TGGACGATCTG -> GGACGATCTGC
GGACGATCTGC -> GACGATCTGCC
GACGATCTGCC -> ACGATCTGCCT
ACGATCTGCCT -> CGATCTGCCTA
CGATCTGCCTA -> GATCTGCCTAC
GATCTGCCTAC -> ATCTGCCTACA
ATCTGCCTACA -> TCTGCCTACAC
TCTGCCTACAC -> CTGCCTACACC
CTGCCTACACC -> TGCCTACACCT
TGCCTACACCT -> GCCTACACCTT
GCCTACACCTT -> CCTACACCTTA
CCTACACCTTA -> CTACACCTTAG
CTACACCTTAG -> TACACCTTAGA
TACACCTTAGA -> ACACCTTAGAA
ACACCTTAGAA -> CACCTTAGAAA
CACCTTAGAAA -> ACCTTAGAAAA
ACCTTAGAAAA -> CCTTAGAAAAT
CCTTAGAAAAT -> CTTAGAAAATC
CTTAGAAAATC -> TTAGAAAATCT
TTAGAAAATCT -> TAGAAAATCTA
TAGAAAATCTA -> AGAAAATCTAT
AGAAAATCTAT -> GAAAATCTATC
GAAAATCTATC -> AAAATCTATCT
AAAATCTATCT -> AAATCTATCTT
AAATCTATCTT -> AATCTATCTTG
AATCTATCTTG -> ATCTATCTTGG
ATCTATCTTGG -> TCTATCTTGGA
TCTATCTTGGA -> CTATCTTGGAA
CTATCTTGGAA -> TATCTTGGAAG
TATCTTGGAAG -> ATCTTGGAAGG
ATCTTGGAAGG -> TCTTGGAAGGG
TCTTGGAAGGG -> CTTGGAAGGGG
CTTGGAAGGGG -> TTGGAAGGGGG
TTGGAAGGGGG -> TGGAAGGGGGT
TGGAAGGGGGT -> GGAAGGGGGTC
GGAAGGGGGTC -> GAAGGGGGTCC
GAAGGGGGTCC -> AAGGGGGTCCT
AAGGGGGTCCT -> AGGGGGTCCTG
AGGGGGTCCTG -> GGGGGTCCTGA
GGGGGTCCTGA -> GGGGTCCTGAT
GGGGTCCTGAT -> GGGTCCTGATT
GGGTCCTGATT -> GGTCCTGATTA
GGTCCTGATTA -> GTCCTGATTAT
GTCCTGATTAT -> TCCTGATTATT
TCCTGATTATT -> CCTGATTATTT
CCTGATTATTT -> CTGATTATTTA
CTGATTATTTA -> TGATTATTTAA
TGATTATTTAA -> GATTATTTAAT
GATTATTTAAT -> ATTATTTAATC
ATTATTTAATC -> TTATTTAATCC
TTATTTAATCC -> TATTTAATCCG
TATTTAATCCG -> ATTTAATCCGA
ATTTAATCCGA -> TTTAATCCGAT
TTTAATCCGAT -> TTAATCCGATG
TTAATCCGATG -> TAATCCGATGC
TAATCCGATGC -> AATCCGATGCC
AATCCGATGCC -> ATCCGATGCCT
ATCCGATGCCT -> TCCGATGCCTT
TCCGATGCCTT -> CCGATGCCTTA
CCGATGCCTTA -> CGATGCCTTAC
CGATGCCTTAC -> GATGCCTTACT
GATGCCTTACT -> ATGCCTTACTT
ATGCCTTACTT -> TGCCTTACTTC
TGCCTTACTTC -> GCCTTACTTCG
GCCTTACTTCG -> CCTTACTTCGA
CCTTACTTCGA -> CTTACTTCGAT
CTTACTTCGAT -> TTACTTCGATG
TTACTTCGATG -> TACTTCGATGC
TACTTCGATGC -> ACTTCGATGCG
ACTTCGATGCG -> CTTCGATGCGG
CTTCGATGCGG -> TTCGATGCGGG
TTCGATGCGGG -> TCGATGCGGGG
TCGATGCGGGG -> CGATGCGGGGC
CGATGCGGGGC -> GATGCGGGGCC
GATGCGGGGCC -> ATGCGGGGCCG
ATGCGGGGCCG -> TGCGGGGCCGA
TGCGGGGCCGA -> GCGGGGCCGAC
GCGGGGCCGAC -> CGGGGCCGACG
CGGGGCCGACG -> GGGGCCGACGT
GGGGCCGACGT -> GGGCCGACGTA
GGGCCGACGTA -> GGCCGACGTAC
GGCCGACGTAC -> GCCGACGTACG
GCCGACGTACG -> CCGACGTACGT
CCGACGTACGT -> CGACGTACGTC
CGACGTACGTC -> GACGTACGTCT
GACGTACGTCT -> ACGTACGTCTC
ACGTACGTCTC -> CGTACGTCTCA
CGTACGTCTCA -> GTACGTCTCAC
GTACGTCTCAC -> TACGTCTCACT
TACGTCTCACT -> ACGTCTCACTG
ACGTCTCACTG -> CGTCTCACTGG
CGTCTCACTGG -> GTCTCACTGGT
GTCTCACTGGT -> TCTCACTGGTT
TCTCACTGGTT -> CTCACTGGTTT
CTCACTGGTTT -> TCACTGGTTTG
TCACTGGTTTG -> CACTGGTTTGA
CACTGGTTTGA -> ACTGGTTTGAT
ACTGGTTTGAT -> CTGGTTTGATC
CTGGTTTGATC -> TGGTTTGATCT
TGGTTTGATCT -> GGTTTGATCTT
GGTTTGATCTT -> GTTTGATCTTG
GTTTGATCTTG -> TTTGATCTTGC
TTTGATCTTGC -> TTGATCTTGCG
TTGATCTTGCG -> TGATCTTGCGT
TGATCTTGCGT -> GATCTTGCGTC
GATCTTGCGTC -> ATCTTGCGTCG
ATCTTGCGTCG -> TCTTGCGTCGA
TCTTGCGTCGA -> CTTGCGTCGAA
CTTGCGTCGAA -> TTGCGTCGAAG
TTGCGTCGAAG -> TGCGTCGAAGT
TGCGTCGAAGT -> GCGTCGAAGTA
GCGTCGAAGTA -> CGTCGAAGTAT
CGTCGAAGTAT -> GTCGAAGTATC
GTCGAAGTATC -> TCGAAGTATCC
TCGAAGTATCC -> CGAAGTATCCA
CGAAGTATCCA -> GAAGTATCCAT
GAAGTATCCAT -> AAGTATCCATG
AAGTATCCATG -> AGTATCCATGG
AGTATCCATGG -> GTATCCATGGA
GTATCCATGGA -> TATCCATGGAG
TATCCATGGAG -> ATCCATGGAGT
ATCCATGGAGT -> TCCATGGAGTA
TCCATGGAGTA -> CCATGGAGTAC
CCATGGAGTAC -> CATGGAGTACT
CATGGAGTACT -> ATGGAGTACTA
ATGGAGTACTA -> TGGAGTACTAG
TGGAGTACTAG -> GGAGTACTAGC
GGAGTACTAGC -> GAGTACTAGCA
GAGTACTAGCA -> AGTACTAGCAT
AGTACTAGCAT -> GTACTAGCATC
GTACTAGCATC -> TACTAGCATCA
TACTAGCATCA -> ACTAGCATCAC
ACTAGCATCAC -> CTAGCATCACA
CTAGCATCACA -> TAGCATCACAA
TAGCATCACAA -> AGCATCACAAG
AGCATCACAAG -> GCATCACAAGA
GCATCACAAGA -> CATCACAAGAT
CATCACAAGAT -> ATCACAAGATA
ATCACAAGATA -> TCACAAGATAT
TCACAAGATAT -> CACAAGATATA
CACAAGATATA -> ACAAGATATAG
ACAAGATATAG -> CAAGATATAGG
CAAGATATAGG -> AAGATATAGGT
AAGATATAGGT -> AGATATAGGTT
AGATATAGGTT -> GATATAGGTTG
GATATAGGTTG -> ATATAGGTTGG
ATATAGGTTGG -> TATAGGTTGGG
TATAGGTTGGG -> ATAGGTTGGGG
ATAGGTTGGGG -> TAGGTTGGGGA
TAGGTTGGGGA -> AGGTTGGGGAA
AGGTTGGGGAA -> GGTTGGGGAAT
GGTTGGGGAAT -> GTTGGGGAATT
GTTGGGGAATT -> TTGGGGAATTT
TTGGGGAATTT -> TGGGGAATTTT
TGGGGAATTTT -> GGGGAATTTTA
GGGGAATTTTA -> GGGAATTTTAG
GGGAATTTTAG -> GGAATTTTAGG
GGAATTTTAGG -> GAATTTTAGGT
GAATTTTAGGT -> AATTTTAGGTC
AATTTTAGGTC -> ATTTTAGGTCG
ATTTTAGGTCG -> TTTTAGGTCGG
TTTTAGGTCGG -> TTTAGGTCGGC
TTTAGGTCGGC -> TTAGGTCGGCT
TTAGGTCGGCT -> TAGGTCGGCTT
TAGGTCGGCTT -> AGGTCGGCTTG
AGGTCGGCTTG -> GGTCGGCTTGG
GGTCGGCTTGG -> GTCGGCTTGGC
GTCGGCTTGGC -> TCGGCTTGGCT
TCGGCTTGGCT -> CGGCTTGGCTG
CGGCTTGGCTG -> GGCTTGGCTGC
GGCTTGGCTGC -> GCTTGGCTGCA
GCTTGGCTGCA -> CTTGGCTGCAT
CTTGGCTGCAT -> TTGGCTGCATA
TTGGCTGCATA -> TGGCTGCATAA
TGGCTGCATAA -> GGCTGCATAAG
GGCTGCATAAG -> GCTGCATAAGT
GCTGCATAAGT -> CTGCATAAGTT
CTGCATAAGTT -> TGCATAAGTTT
TGCATAAGTTT -> GCATAAGTTTT
GCATAAGTTTT -> CATAAGTTTTT
CATAAGTTTTT -> ATAAGTTTTTC
ATAAGTTTTTC -> TAAGTTTTTCG
TAAGTTTTTCG -> AAGTTTTTCGA
AAGTTTTTCGA -> AGTTTTTCGAT
AGTTTTTCGAT -> GTTTTTCGATG
GTTTTTCGATG -> TTTTTCGATGC
TTTTTCGATGC -> TTTTCGATGCT
TTTTCGATGCT -> TTTCGATGCTA
TTTCGATGCTA -> TTCGATGCTAG
TTCGATGCTAG -> TCGATGCTAGG
TCGATGCTAGG -> CGATGCTAGGT
CGATGCTAGGT -> GATGCTAGGTG
GATGCTAGGTG -> ATGCTAGGTGA
ATGCTAGGTGA -> TGCTAGGTGAT
TGCTAGGTGAT -> GCTAGGTGATC
GCTAGGTGATC -> CTAGGTGATCG
CTAGGTGATCG -> TAGGTGATCGC
TAGGTGATCGC -> AGGTGATCGCT
AGGTGATCGCT -> GGTGATCGCTA
GGTGATCGCTA -> GTGATCGCTAT
GTGATCGCTAT -> TGATCGCTATT
TGATCGCTATT -> GATCGCTATTA
GATCGCTATTA -> ATCGCTATTAG
ATCGCTATTAG -> TCGCTATTAGC
TCGCTATTAGC -> CGCTATTAGCT
CGCTATTAGCT -> GCTATTAGCTT
GCTATTAGCTT -> CTATTAGCTTT
CTATTAGCTTT -> TATTAGCTTTG
TATTAGCTTTG -> ATTAGCTTTGT
ATTAGCTTTGT -> TTAGCTTTGTG
TTAGCTTTGTG -> TAGCTTTGTGC
TAGCTTTGTGC -> AGCTTTGTGCA
AGCTTTGTGCA -> GCTTTGTGCAT
GCTTTGTGCAT -> CTTTGTGCATT
CTTTGTGCATT -> TTTGTGCATTA
TTTGTGCATTA -> TTGTGCATTAG
TTGTGCATTAG -> TGTGCATTAGG
TGTGCATTAGG -> GTGCATTAGGG
GTGCATTAGGG -> TGCATTAGGGC
TGCATTAGGGC -> GCATTAGGGCT
GCATTAGGGCT -> CATTAGGGCTG
CATTAGGGCTG -> ATTAGGGCTGC
ATTAGGGCTGC -> TTAGGGCTGCA
TTAGGGCTGCA -> TAGGGCTGCAA
TAGGGCTGCAA -> AGGGCTGCAAT
AGGGCTGCAAT -> GGGCTGCAATA
GGGCTGCAATA -> GGCTGCAATAG
GGCTGCAATAG -> GCTGCAATAGC
GCTGCAATAGC -> CTGCAATAGCA
CTGCAATAGCA -> TGCAATAGCAG
TGCAATAGCAG -> GCAATAGCAGG
GCAATAGCAGG -> CAATAGCAGGC
CAATAGCAGGC -> AATAGCAGGCA
AATAGCAGGCA -> ATAGCAGGCAG
ATAGCAGGCAG -> TAGCAGGCAGA
TAGCAGGCAGA -> AGCAGGCAGAA
AGCAGGCAGAA -> GCAGGCAGAAT
GCAGGCAGAAT -> CAGGCAGAATT
CAGGCAGAATT -> AGGCAGAATTA
AGGCAGAATTA -> GGCAGAATTAA
GGCAGAATTAA -> GCAGAATTAAG
GCAGAATTAAG -> CAGAATTAAGA
CAGAATTAAGA -> AGAATTAAGAG
AGAATTAAGAG -> GAATTAAGAGA
GAATTAAGAGA -> AATTAAGAGAA
AATTAAGAGAA -> ATTAAGAGAAA
ATTAAGAGAAA -> TTAAGAGAAAA
TTAAGAGAAAA -> TAAGAGAAAAA
TAAGAGAAAAA -> AAGAGAAAAAG
AAGAGAAAAAG -> AGAGAAAAAGC
AGAGAAAAAGC -> GAGAAAAAGCT
GAGAAAAAGCT -> AGAAAAAGCTG
AGAAAAAGCTG -> GAAAAAGCTGT
GAAAAAGCTGT -> AAAAAGCTGTT
AAAAAGCTGTT -> AAAAGCTGTTA
AAAAGCTGTTA -> AAAGCTGTTAC
AAAGCTGTTAC -> AAGCTGTTACG
AAGCTGTTACG -> AGCTGTTACGA
AGCTGTTACGA -> GCTGTTACGAG
GCTGTTACGAG -> CTGTTACGAGG
CTGTTACGAGG -> TGTTACGAGGA
TGTTACGAGGA -> GTTACGAGGAC
GTTACGAGGAC -> TTACGAGGACC
TTACGAGGACC -> TACGAGGACCT
TACGAGGACCT -> ACGAGGACCTA
ACGAGGACCTA -> CGAGGACCTAT
CGAGGACCTAT -> GAGGACCTATC
GAGGACCTATC -> AGGACCTATCG
AGGACCTATCG -> GGACCTATCGT
GGACCTATCGT -> GACCTATCGTT
GACCTATCGTT -> ACCTATCGTTA
ACCTATCGTTA -> CCTATCGTTAG
CCTATCGTTAG -> CTATCGTTAGT
CTATCGTTAGT -> TATCGTTAGTT
TATCGTTAGTT -> ATCGTTAGTTT
ATCGTTAGTTT -> TCGTTAGTTTG
TCGTTAGTTTG -> CGTTAGTTTGA
CGTTAGTTTGA -> GTTAGTTTGAG
GTTAGTTTGAG -> TTAGTTTGAGG
TTAGTTTGAGG -> TAGTTTGAGGG
TAGTTTGAGGG -> AGTTTGAGGGG
AGTTTGAGGGG -> GTTTGAGGGGT
GTTTGAGGGGT -> TTTGAGGGGTT
TTTGAGGGGTT -> TTGAGGGGTTT
TTGAGGGGTTT -> TGAGGGGTTTT
TGAGGGGTTTT -> GAGGGGTTTTA
GAGGGGTTTTA -> AGGGGTTTTAA
AGGGGTTTTAA -> GGGGTTTTAAG
GGGGTTTTAAG -> GGGTTTTAAGG
GGGTTTTAAGG -> GGTTTTAAGGT
GGTTTTAAGGT -> GTTTTAAGGTT
GTTTTAAGGTT -> TTTTAAGGTTG
TTTTAAGGTTG -> TTTAAGGTTGA
TTTAAGGTTGA -> TTAAGGTTGAT
TTAAGGTTGAT -> TAAGGTTGATG
TAAGGTTGATG -> AAGGTTGATGG
AAGGTTGATGG -> AGGTTGATGGT
AGGTTGATGGT -> GGTTGATGGTC
GGTTGATGGTC -> GTTGATGGTCT
GTTGATGGTCT -> TTGATGGTCTA
TTGATGGTCTA -> TGATGGTCTAA
TGATGGTCTAA -> GATGGTCTAAC
GATGGTCTAAC -> ATGGTCTAACG
ATGGTCTAACG -> TGGTCTAACGT
TGGTCTAACGT -> GGTCTAACGTA
GGTCTAACGTA -> GTCTAACGTAG
GTCTAACGTAG -> TCTAACGTAGA
TCTAACGTAGA -> CTAACGTAGAT
CTAACGTAGAT -> TAACGTAGATT
TAACGTAGATT -> AACGTAGATTG
AACGTAGATTG -> ACGTAGATTGT
ACGTAGATTGT -> CGTAGATTGTC
CGTAGATTGTC -> GTAGATTGTCA
GTAGATTGTCA -> TAGATTGTCAT
TAGATTGTCAT -> AGATTGTCATA
AGATTGTCATA -> GATTGTCATAT
GATTGTCATAT -> ATTGTCATATT
ATTGTCATATT -> TTGTCATATTA
TTGTCATATTA -> TGTCATATTAA
TGTCATATTAA -> GTCATATTAAC
GTCATATTAAC -> TCATATTAACC
TCATATTAACC -> CATATTAACCA
CATATTAACCA -> ATATTAACCAA
ATATTAACCAA -> TATTAACCAAG
TATTAACCAAG -> ATTAACCAAGA
ATTAACCAAGA -> TTAACCAAGAA
TTAACCAAGAA -> TAACCAAGAAA
TAACCAAGAAA -> AACCAAGAAAG
AACCAAGAAAG -> ACCAAGAAAGG
ACCAAGAAAGG -> CCAAGAAAGGT
CCAAGAAAGGT -> CAAGAAAGGTT
CAAGAAAGGTT -> AAGAAAGGTTA
AAGAAAGGTTA -> AGAAAGGTTAT
AGAAAGGTTAT -> GAAAGGTTATG
GAAAGGTTATG -> AAAGGTTATGT
AAAGGTTATGT -> AAGGTTATGTG
AAGGTTATGTG -> AGGTTATGTGG
AGGTTATGTGG -> GGTTATGTGGG
GGTTATGTGGG -> GTTATGTGGGG
GTTATGTGGGG -> TTATGTGGGGC
TTATGTGGGGC -> TATGTGGGGCG
TATGTGGGGCG -> ATGTGGGGCGT
ATGTGGGGCGT -> TGTGGGGCGTC
TGTGGGGCGTC -> GTGGGGCGTCA
GTGGGGCGTCA -> TGGGGCGTCAA
TGGGGCGTCAA -> GGGGCGTCAAA
GGGGCGTCAAA -> GGGCGTCAAAC
GGGCGTCAAAC -> GGCGTCAAACA
GGCGTCAAACA -> GCGTCAAACAA
GCGTCAAACAA -> CGTCAAACAAG
CGTCAAACAAG -> GTCAAACAAGC
GTCAAACAAGC -> TCAAACAAGCC
TCAAACAAGCC -> CAAACAAGCCA
CAAACAAGCCA -> AAACAAGCCAA
AAACAAGCCAA -> AACAAGCCAAA
AACAAGCCAAA -> ACAAGCCAAAG
ACAAGCCAAAG -> CAAGCCAAAGG
CAAGCCAAAGG -> AAGCCAAAGGC
AAGCCAAAGGC -> AGCCAAAGGCG
AGCCAAAGGCG -> GCCAAAGGCGA
GCCAAAGGCGA -> CCAAAGGCGAT
CCAAAGGCGAT -> CAAAGGCGATT
CAAAGGCGATT -> AAAGGCGATTG
AAAGGCGATTG -> AAGGCGATTGC
AAGGCGATTGC -> AGGCGATTGCT
AGGCGATTGCT -> GGCGATTGCTC
GGCGATTGCTC -> GCGATTGCTCA
GCGATTGCTCA -> CGATTGCTCAC
CGATTGCTCAC -> GATTGCTCACA
GATTGCTCACA -> ATTGCTCACAA
ATTGCTCACAA -> TTGCTCACAAA
TTGCTCACAAA -> TGCTCACAAAC
TGCTCACAAAC -> GCTCACAAACA
GCTCACAAACA -> CTCACAAACAG
CTCACAAACAG -> TCACAAACAGA
TCACAAACAGA -> CACAAACAGAG
CACAAACAGAG -> ACAAACAGAGT
ACAAACAGAGT -> CAAACAGAGTT
CAAACAGAGTT -> AAACAGAGTTC
AAACAGAGTTC -> AACAGAGTTCG
AACAGAGTTCG -> ACAGAGTTCGA
ACAGAGTTCGA -> CAGAGTTCGAT
CAGAGTTCGAT -> AGAGTTCGATA
AGAGTTCGATA -> GAGTTCGATAG
GAGTTCGATAG -> AGTTCGATAGC
AGTTCGATAGC -> GTTCGATAGCT
GTTCGATAGCT -> TTCGATAGCTA
TTCGATAGCTA -> TCGATAGCTAG
TCGATAGCTAG -> CGATAGCTAGT
CGATAGCTAGT -> GATAGCTAGTG
GATAGCTAGTG -> ATAGCTAGTGC
ATAGCTAGTGC -> TAGCTAGTGCC
TAGCTAGTGCC -> AGCTAGTGCCC
AGCTAGTGCCC -> GCTAGTGCCCT
GCTAGTGCCCT -> CTAGTGCCCTC
CTAGTGCCCTC -> TAGTGCCCTCA
TAGTGCCCTCA -> AGTGCCCTCAG
AGTGCCCTCAG -> GTGCCCTCAGT
GTGCCCTCAGT -> TGCCCTCAGTT
TGCCCTCAGTT -> GCCCTCAGTTT
GCCCTCAGTTT -> CCCTCAGTTTC
CCCTCAGTTTC -> CCTCAGTTTCA
CCTCAGTTTCA -> CTCAGTTTCAC
CTCAGTTTCAC -> TCAGTTTCACC
TCAGTTTCACC -> CAGTTTCACCA
CAGTTTCACCA -> AGTTTCACCAG
AGTTTCACCAG -> GTTTCACCAGT
GTTTCACCAGT -> TTTCACCAGTC
TTTCACCAGTC -> TTCACCAGTCG
TTCACCAGTCG -> TCACCAGTCGA
TCACCAGTCGA -> CACCAGTCGAT
CACCAGTCGAT -> ACCAGTCGATA
ACCAGTCGATA -> CCAGTCGATAC
CCAGTCGATAC -> CAGTCGATACA
CAGTCGATACA -> AGTCGATACAG
AGTCGATACAG -> GTCGATACAGC
GTCGATACAGC -> TCGATACAGCA
TCGATACAGCA -> CGATACAGCAT
CGATACAGCAT -> GATACAGCATG
GATACAGCATG -> ATACAGCATGA
ATACAGCATGA -> TACAGCATGAA
TACAGCATGAA -> ACAGCATGAAG
ACAGCATGAAG -> CAGCATGAAGT
CAGCATGAAGT -> AGCATGAAGTA
AGCATGAAGTA -> GCATGAAGTAG
GCATGAAGTAG -> CATGAAGTAGT
CATGAAGTAGT -> ATGAAGTAGTT
ATGAAGTAGTT -> TGAAGTAGTTA
TGAAGTAGTTA -> GAAGTAGTTAC
GAAGTAGTTAC -> AAGTAGTTACA
AAGTAGTTACA -> AGTAGTTACAT
AGTAGTTACAT -> GTAGTTACATC
GTAGTTACATC -> TAGTTACATCG
TAGTTACATCG -> AGTTACATCGT
AGTTACATCGT -> GTTACATCGTC
GTTACATCGTC -> TTACATCGTCA
TTACATCGTCA -> TACATCGTCAT
TACATCGTCAT -> ACATCGTCATA
ACATCGTCATA -> CATCGTCATAT
CATCGTCATAT -> ATCGTCATATG
ATCGTCATATG -> TCGTCATATGA
TCGTCATATGA -> CGTCATATGAC
CGTCATATGAC -> GTCATATGACG
GTCATATGACG -> TCATATGACGC
TCATATGACGC -> CATATGACGCC
CATATGACGCC -> ATATGACGCCC
ATATGACGCCC -> TATGACGCCCA
TATGACGCCCA -> ATGACGCCCAA
ATGACGCCCAA -> TGACGCCCAAG
TGACGCCCAAG -> GACGCCCAAGC
GACGCCCAAGC -> ACGCCCAAGCT
ACGCCCAAGCT -> CGCCCAAGCTA
CGCCCAAGCTA -> GCCCAAGCTAA
GCCCAAGCTAA -> CCCAAGCTAAA
CCCAAGCTAAA -> CCAAGCTAAAA
CCAAGCTAAAA -> CAAGCTAAAAG
CAAGCTAAAAG -> AAGCTAAAAGG
AAGCTAAAAGG -> AGCTAAAAGGA
AGCTAAAAGGA -> GCTAAAAGGAG
GCTAAAAGGAG -> CTAAAAGGAGA
CTAAAAGGAGA -> TAAAAGGAGAA
TAAAAGGAGAA -> AAAAGGAGAAC
AAAAGGAGAAC -> AAAGGAGAACC
AAAGGAGAACC -> AAGGAGAACCT
AAGGAGAACCT -> AGGAGAACCTC
AGGAGAACCTC -> GGAGAACCTCA
GGAGAACCTCA -> GAGAACCTCAA
GAGAACCTCAA -> AGAACCTCAAA
AGAACCTCAAA -> GAACCTCAAAC
GAACCTCAAAC -> AACCTCAAACC
AACCTCAAACC -> ACCTCAAACCT
ACCTCAAACCT -> CCTCAAACCTA
CCTCAAACCTA -> CTCAAACCTAG
CTCAAACCTAG -> TCAAACCTAGG
TCAAACCTAGG -> CAAACCTAGGT
CAAACCTAGGT -> AAACCTAGGTG
AAACCTAGGTG -> AACCTAGGTGA
AACCTAGGTGA -> ACCTAGGTGAC
ACCTAGGTGAC -> CCTAGGTGACC
CCTAGGTGACC -> CTAGGTGACCT
CTAGGTGACCT -> TAGGTGACCTG
TAGGTGACCTG -> AGGTGACCTGG
AGGTGACCTGG -> GGTGACCTGGT
GGTGACCTGGT -> GTGACCTGGTT
GTGACCTGGTT -> TGACCTGGTTG
TGACCTGGTTG -> GACCTGGTTGC
GACCTGGTTGC -> ACCTGGTTGCC
ACCTGGTTGCC -> CCTGGTTGCCA
CCTGGTTGCCA -> CTGGTTGCCAC
CTGGTTGCCAC -> TGGTTGCCACA
TGGTTGCCACA -> GGTTGCCACAT
GGTTGCCACAT -> GTTGCCACATA
GTTGCCACATA -> TTGCCACATAC
TTGCCACATAC -> TGCCACATACT
TGCCACATACT -> GCCACATACTC
GCCACATACTC -> CCACATACTCT
CCACATACTCT -> CACATACTCTA
CACATACTCTA -> ACATACTCTAA
ACATACTCTAA -> CATACTCTAAG
CATACTCTAAG -> ATACTCTAAGC
ATACTCTAAGC -> TACTCTAAGCA
TACTCTAAGCA -> ACTCTAAGCAG
ACTCTAAGCAG -> CTCTAAGCAGA
CTCTAAGCAGA -> TCTAAGCAGAA
TCTAAGCAGAA -> CTAAGCAGAAA
CTAAGCAGAAA -> TAAGCAGAAAA
TAAGCAGAAAA -> AAGCAGAAAAC
AAGCAGAAAAC -> AGCAGAAAACG
AGCAGAAAACG -> GCAGAAAACGC
GCAGAAAACGC -> CAGAAAACGCC
CAGAAAACGCC -> AGAAAACGCCG
AGAAAACGCCG -> GAAAACGCCGA
GAAAACGCCGA -> AAAACGCCGAA
AAAACGCCGAA -> AAACGCCGAAC
AAACGCCGAAC -> AACGCCGAACG
AACGCCGAACG -> ACGCCGAACGA
ACGCCGAACGA -> CGCCGAACGAA
CGCCGAACGAA -> GCCGAACGAAT
GCCGAACGAAT -> CCGAACGAATA
CCGAACGAATA -> CGAACGAATAT
CGAACGAATAT -> GAACGAATATA
GAACGAATATA -> AACGAATATAG
AACGAATATAG -> ACGAATATAGT
ACGAATATAGT -> CGAATATAGTC
CGAATATAGTC -> GAATATAGTCC
GAATATAGTCC -> AATATAGTCCA
AATATAGTCCA -> ATATAGTCCAA
ATATAGTCCAA -> TATAGTCCAAA
TATAGTCCAAA -> ATAGTCCAAAG
ATAGTCCAAAG -> TAGTCCAAAGG
TAGTCCAAAGG -> AGTCCAAAGGT
AGTCCAAAGGT -> GTCCAAAGGTC
GTCCAAAGGTC -> TCCAAAGGTCC
TCCAAAGGTCC -> CCAAAGGTCCA
CCAAAGGTCCA -> CAAAGGTCCAG
CAAAGGTCCAG -> AAAGGTCCAGG
AAAGGTCCAGG -> AAGGTCCAGGC
AAGGTCCAGGC -> AGGTCCAGGCT
AGGTCCAGGCT -> GGTCCAGGCTA
GGTCCAGGCTA -> GTCCAGGCTAA
GTCCAGGCTAA -> TCCAGGCTAAA
TCCAGGCTAAA -> CCAGGCTAAAT
CCAGGCTAAAT -> CAGGCTAAATA
CAGGCTAAATA -> AGGCTAAATAT
AGGCTAAATAT -> GGCTAAATATA
GGCTAAATATA -> GCTAAATATAG
GCTAAATATAG -> CTAAATATAGG
CTAAATATAGG -> TAAATATAGGT
TAAATATAGGT -> AAATATAGGTC
AAATATAGGTC -> AATATAGGTCG
AATATAGGTCG -> ATATAGGTCGT
ATATAGGTCGT -> TATAGGTCGTA
TATAGGTCGTA -> ATAGGTCGTAC
ATAGGTCGTAC -> TAGGTCGTACA
TAGGTCGTACA -> AGGTCGTACAG
AGGTCGTACAG -> GGTCGTACAGA
GGTCGTACAGA -> GTCGTACAGAA
GTCGTACAGAA -> TCGTACAGAAT
TCGTACAGAAT -> CGTACAGAATA
CGTACAGAATA -> GTACAGAATAA
GTACAGAATAA -> TACAGAATAAG
TACAGAATAAG -> ACAGAATAAGG
ACAGAATAAGG -> CAGAATAAGGT
CAGAATAAGGT -> AGAATAAGGTT
AGAATAAGGTT -> GAATAAGGTTC
GAATAAGGTTC -> AATAAGGTTCA
AATAAGGTTCA -> ATAAGGTTCAG
ATAAGGTTCAG -> TAAGGTTCAGG
TAAGGTTCAGG -> AAGGTTCAGGA
AAGGTTCAGGA -> AGGTTCAGGAT
AGGTTCAGGAT -> GGTTCAGGATG
GGTTCAGGATG -> GTTCAGGATGG
GTTCAGGATGG -> TTCAGGATGGT
TTCAGGATGGT -> TCAGGATGGTG
TCAGGATGGTG -> CAGGATGGTGA
CAGGATGGTGA -> AGGATGGTGAA
AGGATGGTGAA -> GGATGGTGAAT
GGATGGTGAAT -> GATGGTGAATT
GATGGTGAATT -> ATGGTGAATTT
ATGGTGAATTT -> TGGTGAATTTA
TGGTGAATTTA -> GGTGAATTTAA
GGTGAATTTAA -> GTGAATTTAAT
GTGAATTTAAT -> TGAATTTAATG
TGAATTTAATG -> GAATTTAATGC
GAATTTAATGC -> AATTTAATGCA
AATTTAATGCA -> ATTTAATGCAA
ATTTAATGCAA -> TTTAATGCAAA
TTTAATGCAAA -> TTAATGCAAAA
TTAATGCAAAA -> TAATGCAAAAG
TAATGCAAAAG -> AATGCAAAAGA
AATGCAAAAGA -> ATGCAAAAGAG
ATGCAAAAGAG -> TGCAAAAGAGC
TGCAAAAGAGC -> GCAAAAGAGCC
GCAAAAGAGCC -> CAAAAGAGCCT
CAAAAGAGCCT -> AAAAGAGCCTC
AAAAGAGCCTC -> AAAGAGCCTCC
AAAGAGCCTCC -> AAGAGCCTCCT
AAGAGCCTCCT -> AGAGCCTCCTT
AGAGCCTCCTT -> GAGCCTCCTTA
GAGCCTCCTTA -> AGCCTCCTTAG
AGCCTCCTTAG -> GCCTCCTTAGG
GCCTCCTTAGG -> CCTCCTTAGGC
CCTCCTTAGGC -> CTCCTTAGGCT
CTCCTTAGGCT -> TCCTTAGGCTT
TCCTTAGGCTT -> CCTTAGGCTTG
CCTTAGGCTTG -> CTTAGGCTTGG
CTTAGGCTTGG -> TTAGGCTTGGG
TTAGGCTTGGG -> TAGGCTTGGGA
TAGGCTTGGGA -> AGGCTTGGGAT
AGGCTTGGGAT -> GGCTTGGGATG
GGCTTGGGATG -> GCTTGGGATGG
GCTTGGGATGG -> CTTGGGATGGG
CTTGGGATGGG -> TTGGGATGGGG
TTGGGATGGGG -> TGGGATGGGGG
TGGGATGGGGG -> GGGATGGGGGC
GGGATGGGGGC -> GGATGGGGGCT
GGATGGGGGCT -> GATGGGGGCTC
GATGGGGGCTC -> ATGGGGGCTCT
ATGGGGGCTCT -> TGGGGGCTCTT
TGGGGGCTCTT -> GGGGGCTCTTA
GGGGGCTCTTA -> GGGGCTCTTAT
GGGGCTCTTAT -> GGGCTCTTATA
GGGCTCTTATA -> GGCTCTTATAA
GGCTCTTATAA -> GCTCTTATAAC
GCTCTTATAAC -> CTCTTATAACA
CTCTTATAACA -> TCTTATAACAG
TCTTATAACAG -> CTTATAACAGC
CTTATAACAGC -> TTATAACAGCT
TTATAACAGCT -> TATAACAGCTG
TATAACAGCTG -> ATAACAGCTGG
ATAACAGCTGG -> TAACAGCTGGG
TAACAGCTGGG -> AACAGCTGGGG
AACAGCTGGGG -> ACAGCTGGGGT
ACAGCTGGGGT -> CAGCTGGGGTG
CAGCTGGGGTG -> AGCTGGGGTGC
AGCTGGGGTGC -> GCTGGGGTGCA
GCTGGGGTGCA -> CTGGGGTGCAA
CTGGGGTGCAA -> TGGGGTGCAAT
TGGGGTGCAAT -> GGGGTGCAATA
GGGGTGCAATA -> GGGTGCAATAT
GGGTGCAATAT -> GGTGCAATATC
GGTGCAATATC -> GTGCAATATCG
GTGCAATATCG -> TGCAATATCGC
TGCAATATCGC -> GCAATATCGCG
GCAATATCGCG -> CAATATCGCGT
CAATATCGCGT -> AATATCGCGTT
AATATCGCGTT -> ATATCGCGTTA
ATATCGCGTTA -> TATCGCGTTAG
TATCGCGTTAG -> ATCGCGTTAGC
ATCGCGTTAGC -> TCGCGTTAGCT
TCGCGTTAGCT -> CGCGTTAGCTG
CGCGTTAGCTG -> GCGTTAGCTGT
GCGTTAGCTGT -> CGTTAGCTGTC
CGTTAGCTGTC -> GTTAGCTGTCT
GTTAGCTGTCT -> TTAGCTGTCTG
TTAGCTGTCTG -> TAGCTGTCTGT
TAGCTGTCTGT -> AGCTGTCTGTG
AGCTGTCTGTG -> GCTGTCTGTGA
GCTGTCTGTGA -> CTGTCTGTGAG
CTGTCTGTGAG -> TGTCTGTGAGT
TGTCTGTGAGT -> GTCTGTGAGTG
GTCTGTGAGTG -> TCTGTGAGTGT
TCTGTGAGTGT -> CTGTGAGTGTC
CTGTGAGTGTC -> TGTGAGTGTCC
TGTGAGTGTCC -> GTGAGTGTCCG
GTGAGTGTCCG -> TGAGTGTCCGA
TGAGTGTCCGA -> GAGTGTCCGAA
GAGTGTCCGAA -> AGTGTCCGAAA
AGTGTCCGAAA -> GTGTCCGAAAT
GTGTCCGAAAT -> TGTCCGAAATC
TGTCCGAAATC -> GTCCGAAATCT
GTCCGAAATCT -> TCCGAAATCTA
TCCGAAATCTA -> CCGAAATCTAG
CCGAAATCTAG -> CGAAATCTAGT
CGAAATCTAGT -> GAAATCTAGTA
GAAATCTAGTA -> AAATCTAGTAC
AAATCTAGTAC -> AATCTAGTACC
AATCTAGTACC -> ATCTAGTACCC
ATCTAGTACCC -> TCTAGTACCCC
TCTAGTACCCC -> CTAGTACCCCG
CTAGTACCCCG -> TAGTACCCCGA
TAGTACCCCGA -> AGTACCCCGAA
AGTACCCCGAA -> GTACCCCGAAG
GTACCCCGAAG -> TACCCCGAAGT
TACCCCGAAGT -> ACCCCGAAGTC
ACCCCGAAGTC -> CCCCGAAGTCT
CCCCGAAGTCT -> CCCGAAGTCTT
CCCGAAGTCTT -> CCGAAGTCTTC
CCGAAGTCTTC -> CGAAGTCTTCC
CGAAGTCTTCC -> GAAGTCTTCCC
GAAGTCTTCCC -> AAGTCTTCCCC
AAGTCTTCCCC -> AGTCTTCCCCT
AGTCTTCCCCT -> GTCTTCCCCTT
GTCTTCCCCTT -> TCTTCCCCTTT
TCTTCCCCTTT -> CTTCCCCTTTC
CTTCCCCTTTC -> TTCCCCTTTCA
TTCCCCTTTCA -> TCCCCTTTCAT
TCCCCTTTCAT -> CCCCTTTCATA
CCCCTTTCATA -> CCCTTTCATAA
CCCTTTCATAA -> CCTTTCATAAC
CCTTTCATAAC -> CTTTCATAACG
CTTTCATAACG -> TTTCATAACGT
TTTCATAACGT -> TTCATAACGTC
TTCATAACGTC -> TCATAACGTCC
TCATAACGTCC -> CATAACGTCCC
CATAACGTCCC -> ATAACGTCCCG
ATAACGTCCCG -> TAACGTCCCGA
TAACGTCCCGA -> AACGTCCCGAG
AACGTCCCGAG -> ACGTCCCGAGA
ACGTCCCGAGA -> CGTCCCGAGAA
CGTCCCGAGAA -> GTCCCGAGAAG
GTCCCGAGAAG -> TCCCGAGAAGG
TCCCGAGAAGG -> CCCGAGAAGGA
CCCGAGAAGGA -> CCGAGAAGGAT
CCGAGAAGGAT -> CGAGAAGGATT
CGAGAAGGATT -> GAGAAGGATTT
GAGAAGGATTT -> AGAAGGATTTG
AGAAGGATTTG -> GAAGGATTTGT
GAAGGATTTGT -> AAGGATTTGTA
AAGGATTTGTA -> AGGATTTGTAG
AGGATTTGTAG -> GGATTTGTAGG
GGATTTGTAGG -> GATTTGTAGGG
GATTTGTAGGG -> ATTTGTAGGGT
ATTTGTAGGGT -> TTTGTAGGGTG
TTTGTAGGGTG -> TTGTAGGGTGA
TTGTAGGGTGA -> TGTAGGGTGAC
TGTAGGGTGAC -> GTAGGGTGACT
GTAGGGTGACT -> TAGGGTGACTT
TAGGGTGACTT -> AGGGTGACTTA
AGGGTGACTTA -> GGGTGACTTAC
GGGTGACTTAC -> GGTGACTTACA
GGTGACTTACA -> GTGACTTACAG
GTGACTTACAG -> TGACTTACAGA
TGACTTACAGA -> GACTTACAGAC
GACTTACAGAC -> ACTTACAGACC
ACTTACAGACC -> CTTACAGACCG
CTTACAGACCG -> TTACAGACCGC
TTACAGACCGC -> TACAGACCGCG
TACAGACCGCG -> ACAGACCGCGA
ACAGACCGCGA -> CAGACCGCGAG
CAGACCGCGAG -> AGACCGCGAGG
AGACCGCGAGG -> GACCGCGAGGT
GACCGCGAGGT -> ACCGCGAGGTG
ACCGCGAGGTG -> CCGCGAGGTGC
CCGCGAGGTGC -> CGCGAGGTGCA
CGCGAGGTGCA -> GCGAGGTGCAT
GCGAGGTGCAT -> CGAGGTGCATA
CGAGGTGCATA -> GAGGTGCATAT
GAGGTGCATAT -> AGGTGCATATG
AGGTGCATATG -> GGTGCATATGT
GGTGCATATGT -> GTGCATATGTG
GTGCATATGTG -> TGCATATGTGT
TGCATATGTGT -> GCATATGTGTA
GCATATGTGTA -> CATATGTGTAT
CATATGTGTAT -> ATATGTGTATT
ATATGTGTATT -> TATGTGTATTC
TATGTGTATTC -> ATGTGTATTCA
ATGTGTATTCA -> TGTGTATTCAG
TGTGTATTCAG -> GTGTATTCAGT
GTGTATTCAGT -> TGTATTCAGTG
TGTATTCAGTG -> GTATTCAGTGG
GTATTCAGTGG -> TATTCAGTGGA
TATTCAGTGGA -> ATTCAGTGGAT
ATTCAGTGGAT -> TTCAGTGGATA
TTCAGTGGATA -> TCAGTGGATAT
TCAGTGGATAT -> CAGTGGATATA
CAGTGGATATA -> AGTGGATATAG
AGTGGATATAG -> GTGGATATAGT
GTGGATATAGT -> TGGATATAGTT
TGGATATAGTT -> GGATATAGTTA
GGATATAGTTA -> GATATAGTTAG
GATATAGTTAG -> ATATAGTTAGC
ATATAGTTAGC -> TATAGTTAGCT
TATAGTTAGCT -> ATAGTTAGCTA
ATAGTTAGCTA -> TAGTTAGCTAG
TAGTTAGCTAG -> AGTTAGCTAGC
AGTTAGCTAGC -> GTTAGCTAGCA
GTTAGCTAGCA -> TTAGCTAGCAT
TTAGCTAGCAT -> TAGCTAGCATA
TAGCTAGCATA -> AGCTAGCATAC
AGCTAGCATAC -> GCTAGCATACT
GCTAGCATACT -> CTAGCATACTA
CTAGCATACTA -> TAGCATACTAA
TAGCATACTAA -> AGCATACTAAC
AGCATACTAAC -> GCATACTAACC
GCATACTAACC -> CATACTAACCG
CATACTAACCG -> ATACTAACCGA
ATACTAACCGA -> TACTAACCGAC
TACTAACCGAC -> ACTAACCGACC
ACTAACCGACC -> CTAACCGACCT
CTAACCGACCT -> TAACCGACCTG
TAACCGACCTG -> AACCGACCTGC
AACCGACCTGC -> ACCGACCTGCG
ACCGACCTGCG -> CCGACCTGCGC
CCGACCTGCGC -> CGACCTGCGCT
CGACCTGCGCT -> GACCTGCGCTG
GACCTGCGCTG -> ACCTGCGCTGA
ACCTGCGCTGA -> CCTGCGCTGAC
CCTGCGCTGAC -> CTGCGCTGACC
CTGCGCTGACC -> TGCGCTGACCC
TGCGCTGACCC -> GCGCTGACCCA
GCGCTGACCCA -> CGCTGACCCAT
CGCTGACCCAT -> GCTGACCCATT
GCTGACCCATT -> CTGACCCATTA
CTGACCCATTA -> TGACCCATTAC
TGACCCATTAC -> GACCCATTACC
GACCCATTACC -> ACCCATTACCG
ACCCATTACCG -> CCCATTACCGT
CCCATTACCGT -> CCATTACCGTC
CCATTACCGTC -> CATTACCGTCC
CATTACCGTCC -> ATTACCGTCCC
ATTACCGTCCC -> TTACCGTCCCC
TTACCGTCCCC -> TACCGTCCCCC
TACCGTCCCCC -> ACCGTCCCCCT
ACCGTCCCCCT -> CCGTCCCCCTA
CCGTCCCCCTA -> CGTCCCCCTAT
CGTCCCCCTAT -> GTCCCCCTATG
GTCCCCCTATG -> TCCCCCTATGT
TCCCCCTATGT -> CCCCCTATGTA
CCCCCTATGTA -> CCCCTATGTAG
CCCCTATGTAG -> CCCTATGTAGA
CCCTATGTAGA -> CCTATGTAGAT
CCTATGTAGAT -> CTATGTAGATC
CTATGTAGATC -> TATGTAGATCC
TATGTAGATCC -> ATGTAGATCCG
ATGTAGATCCG -> TGTAGATCCGA
TGTAGATCCGA -> GTAGATCCGAT
GTAGATCCGAT -> TAGATCCGATT
TAGATCCGATT -> AGATCCGATTC
AGATCCGATTC -> GATCCGATTCT
GATCCGATTCT -> ATCCGATTCTC
ATCCGATTCTC -> TCCGATTCTCC
TCCGATTCTCC -> CCGATTCTCCG
CCGATTCTCCG -> CGATTCTCCGT
CGATTCTCCGT -> GATTCTCCGTG
GATTCTCCGTG -> ATTCTCCGTGT
ATTCTCCGTGT -> TTCTCCGTGTT
TTCTCCGTGTT -> TCTCCGTGTTA
TCTCCGTGTTA -> CTCCGTGTTAT
CTCCGTGTTAT -> TCCGTGTTATG
TCCGTGTTATG -> CCGTGTTATGT
CCGTGTTATGT -> CGTGTTATGTG
CGTGTTATGTG -> GTGTTATGTGT
GTGTTATGTGT -> TGTTATGTGTA
TGTTATGTGTA -> GTTATGTGTAA
