CTTGATGTGCAGTAAGCCA -> TTGATGTGCAGTAAGCCAC
GCAGATTCGGGTGAACGGA -> CAGATTCGGGTGAACGGAC
ATTTGAGGATGCCCCACTG -> TTTGAGGATGCCCCACTGG
GAAAATGTAGAAATAGGAG -> AAAATGTAGAAATAGGAGG
CGCACTGTCAATGCTGCAT -> GCACTGTCAATGCTGCATC
TAGTAGGTCTAGGGCGATA -> AGTAGGTCTAGGGCGATAC
CGCTCGCATAATGAACTTA -> GCTCGCATAATGAACTTAG
ACTCCCTTGTAGGACCTTA -> CTCCCTTGTAGGACCTTAA
GTAAGCCACTAAGCGTTAA -> TAAGCCACTAAGCGTTAAG
TAATGTCCGTTCATACGGT -> AATGTCCGTTCATACGGTT
GAACACAAGGTACTCCGCT -> AACACAAGGTACTCCGCTC
ACACGGTGCGCCTGCGCAA -> CACGGTGCGCCTGCGCAAG
CAGTTCAAAGATAGACATC -> AGTTCAAAGATAGACATCT
GACCTGGGACTCCAACTTG -> ACCTGGGACTCCAACTTGA
TTAAGGTATGCGCTGAGGG -> TAAGGTATGCGCTGAGGGG
GCCCTAAGGGGACGAATTC -> CCCTAAGGGGACGAATTCG
ACTGGAGGTTCCATTCTAG -> CTGGAGGTTCCATTCTAGC
ACCCTTCCAAACCGTCCTC -> CCCTTCCAAACCGTCCTCA
ACCTCTATATCTTTGTGTT -> CCTCTATATCTTTGTGTTG
TGTCACACAGATGGAAGCA -> GTCACACAGATGGAAGCAT
AACTCACGGAGCTGACGCC -> ACTCACGGAGCTGACGCCC
TTGCGATCCCGGCTAGATC -> TGCGATCCCGGCTAGATCA
GTATGTTTTGCGATCCCGG -> TATGTTTTGCGATCCCGGC
AGGGGCACCAACACACTGG -> GGGGCACCAACACACTGGA
CGCTAGACCAGATGGCCAT -> GCTAGACCAGATGGCCATC
TCCGTGAAACGCCCTAGTA -> CCGTGAAACGCCCTAGTAA
TAAGCGTTAAGAACAATCG -> AAGCGTTAAGAACAATCGG
GACGCTGGCGCCGCAGTGC -> ACGCTGGCGCCGCAGTGCG
GGGACGAATTCGTTTTATC -> GGACGAATTCGTTTTATCG
ATGGAAAAAGTGTTCACTG -> TGGAAAAAGTGTTCACTGG
ACCCGTGTATTTGAGGATG -> CCCGTGTATTTGAGGATGC
TGACTTTCGTGGCACTGGC -> GACTTTCGTGGCACTGGCC
ATCATAAGCCAGTGACCTA -> TCATAAGCCAGTGACCTAT
AAACCCGTGTATTTGAGGA -> AACCCGTGTATTTGAGGAT
CGGAGTGAATTTACGGGCG -> GGAGTGAATTTACGGGCGA
ACCTGTAGCACCGTTCAAA -> CCTGTAGCACCGTTCAAAA
ACTCACTGGGTGTCCCAAC -> CTCACTGGGTGTCCCAACT
CACTACCCTAGCTCTGTGA -> ACTACCCTAGCTCTGTGAC
GAGGTCACGTCGCTACTGT -> AGGTCACGTCGCTACTGTC
CTCACGGAGCTGACGCCCC -> TCACGGAGCTGACGCCCCT
CGTAGCTGGACTCCAGTAC -> GTAGCTGGACTCCAGTACA
CCACTAAGACTTAGAATAC -> CACTAAGACTTAGAATACC
CGGCCGTTATATTTATTTG -> GGCCGTTATATTTATTTGC
GCTGGACTCCAGTACAAAT -> CTGGACTCCAGTACAAATG
CTTAGTAGGTCTAGGGCGA -> TTAGTAGGTCTAGGGCGAT
CCTGACTTTCGTGGCACTG -> CTGACTTTCGTGGCACTGG
GTGAGCCAAATGGCCGTTA -> TGAGCCAAATGGCCGTTAT
GAAGAAGTATATTCTGGTA -> AAGAAGTATATTCTGGTAC
TCGACACTACCCTAGCTCT -> CGACACTACCCTAGCTCTG
CTCTACTTGACTGTCACAC -> TCTACTTGACTGTCACACA
GTGCGTCATAGCCAGGCAA -> TGCGTCATAGCCAGGCAAC
GAATCTCCGAAGTGAGCCA -> AATCTCCGAAGTGAGCCAA
CCTCGATTCCCTAGATGGC -> CTCGATTCCCTAGATGGCG
TTGGCTAATGTCCGTTCAT -> TGGCTAATGTCCGTTCATA
CTCACTGGGTGTCCCAACT -> TCACTGGGTGTCCCAACTA
CTAATGTCCGTTCATACGG -> TAATGTCCGTTCATACGGT
CATCCCGTTTTCGAGGTCA -> ATCCCGTTTTCGAGGTCAC
TGGAAAAAGTGTTCACTGG -> GGAAAAAGTGTTCACTGGC
AATGTCCGTTCATACGGTT -> ATGTCCGTTCATACGGTTG
GGCGATACCCGGAGCAGGG -> GCGATACCCGGAGCAGGGT
TATATTTATTTGCTAGCCG -> ATATTTATTTGCTAGCCGG
GGGCACCAACACACTGGAG -> GGCACCAACACACTGGAGG
TCTGTCAGCTAGTGTGCCT -> CTGTCAGCTAGTGTGCCTG
GGCGTCAGTACGTATGTCC -> GCGTCAGTACGTATGTCCA
GTACTGATTCCTTTGCTGA -> TACTGATTCCTTTGCTGAT
AGTGCTAATCGCAGGTTAG -> GTGCTAATCGCAGGTTAGT
TTTATTTGTGCAGAGAATT -> TTATTTGTGCAGAGAATTC
ATACCCGGAGCAGGGTGGC -> TACCCGGAGCAGGGTGGCC
TTTGCGACCCACTCCCTTG -> TTGCGACCCACTCCCTTGT
TTTACTTATAATACGCGGC -> TTACTTATAATACGCGGCA
CTCCCGACCATTTTGAGAA -> TCCCGACCATTTTGAGAAC
TGAACTTAGTAGGTCTAGG -> GAACTTAGTAGGTCTAGGG
ACGCCCAAAAGCATAACGT -> CGCCCAAAAGCATAACGTA
GTGTACGTTCGGGGATTTG -> TGTACGTTCGGGGATTTGC
TATATTCTGGTACTGATTC -> ATATTCTGGTACTGATTCC
TAGATCAAGAAGGCCTTTA -> AGATCAAGAAGGCCTTTAC
CATACCGTGATCTGGAGAA -> ATACCGTGATCTGGAGAAC
GAGCTGACGCCCCTCCTAG -> AGCTGACGCCCCTCCTAGA
CAAGAGGCAGATTCGGGTG -> AAGAGGCAGATTCGGGTGA
CGCGGCAGGTTGATGCGTC -> GCGGCAGGTTGATGCGTCG
AAGCCGGGGCTTGCTCCCG -> AGCCGGGGCTTGCTCCCGA
TTAAGAGCCAAGGATTTTA -> TAAGAGCCAAGGATTTTAG
TACAGCAATCATAAGCCAG -> ACAGCAATCATAAGCCAGT
ACGTAAATCCTGGTCTTGA -> CGTAAATCCTGGTCTTGAC
GATTGACCATCCGCTCGGT -> ATTGACCATCCGCTCGGTA
CCCACTCCCTTGTAGGACC -> CCACTCCCTTGTAGGACCT, CCACTCCCTTGTAGGACCT
TCCCCCAGGGCTTATTATA -> CCCCCAGGGCTTATTATAT
TCGTTGCGTACCTCTATAT -> CGTTGCGTACCTCTATATC
AACACCCCTTAAGAGCCAA -> ACACCCCTTAAGAGCCAAG
TAGTGTGGAGTTTCCCACT -> AGTGTGGAGTTTCCCACTA
GCCTAGATGTACCAAGGCC -> CCTAGATGTACCAAGGCCG
CAAACCGTCCTCATAACCT -> AAACCGTCCTCATAACCTA
CGGTTGCTTTTGGGGGGCC -> GGTTGCTTTTGGGGGGCCG
ACAAAGCCGGGGCTTGCTC -> CAAAGCCGGGGCTTGCTCC
TTAAGTGCTAATCGCAGGT -> TAAGTGCTAATCGCAGGTT
CTCCCTTGTAGGACCTCAG -> TCCCTTGTAGGACCTCAGA
CGTGAAACGCCCTAGTAAT -> GTGAAACGCCCTAGTAATT
TAACCTATGCCTTGCCTGG -> AACCTATGCCTTGCCTGGA
TAGATGTTAAGGTATGCGC -> AGATGTTAAGGTATGCGCT
GACTTTCGTGGCACTGGCC -> ACTTTCGTGGCACTGGCCG
CGAAGGCGCGGCGAACTAC -> GAAGGCGCGGCGAACTACT
TTGGACGTAAATCCTGGTC -> TGGACGTAAATCCTGGTCT
CTGCGTTCCCTGAACCGGC -> TGCGTTCCCTGAACCGGCG
TCTAGGGCGATACCCGGAG -> CTAGGGCGATACCCGGAGC
GCAGTTCAAAGATAGACAT -> CAGTTCAAAGATAGACATC
CGTTTTCGAGGTCACGTCG -> GTTTTCGAGGTCACGTCGC
GGTGGTCGACACTACCCTA -> GTGGTCGACACTACCCTAG
TGGTGGGTTGAGGGTCCAC -> GGTGGGTTGAGGGTCCACG
CTGGAGGTTCCATTCTAGC -> TGGAGGTTCCATTCTAGCG
ACTTTCGTGGCACTGGCCG -> CTTTCGTGGCACTGGCCGG
AGTGCGAAAGTGAAAAAGA -> GTGCGAAAGTGAAAAAGAT
GTCATCTGCGTACAGGTGA -> TCATCTGCGTACAGGTGAA
GTACCAAGGCCGTTATATT -> TACCAAGGCCGTTATATTT
AGTGTTCACTGGCTTCTCA -> GTGTTCACTGGCTTCTCAA
GTGCGCCTGCGCAAGATGG -> TGCGCCTGCGCAAGATGGA
GTGGAGTTTCCCACTAAGA -> TGGAGTTTCCCACTAAGAC
CTAGGGCGATACCCGGAGC -> TAGGGCGATACCCGGAGCA
CCCTTGGCTAATGTCCGTT -> CCTTGGCTAATGTCCGTTC
GTTGCTTTTGGGGGGCCGT -> TTGCTTTTGGGGGGCCGTT
GAAAAAGTGTTCACTGGCT -> AAAAAGTGTTCACTGGCTT
TTCCACTCCCTTGTAGGAC -> TCCACTCCCTTGTAGGACC
CAGGTTTCGACAGTTGGTA -> AGGTTTCGACAGTTGGTAG
TCTGGTGGGTTGAGGGTCC -> CTGGTGGGTTGAGGGTCCA
GCGAAGAAGTATATTCTGG -> CGAAGAAGTATATTCTGGT
ACACTACCCTAGCTCTGTG -> CACTACCCTAGCTCTGTGA
CATCTGTCAGCTAGTGTGC -> ATCTGTCAGCTAGTGTGCC
ACCTATGATGAGGCGCATA -> CCTATGATGAGGCGCATAG
ATTCGATCTTGAAACGGGC -> TTCGATCTTGAAACGGGCA
GTTCAACATCCGTCTCATG -> TTCAACATCCGTCTCATGA
AAATGTAGAAATAGGAGGA -> AATGTAGAAATAGGAGGAG
CAAAGTTGGAGAGTGACCG -> AAAGTTGGAGAGTGACCGA
AGTCACGGAGTGAATTTAC -> GTCACGGAGTGAATTTACG
GTCTCATGATAAGCGGTAC -> TCTCATGATAAGCGGTACG
AGGCGTGCGTCATAGCCAG -> GGCGTGCGTCATAGCCAGG
GGCCATCGCTCGATAGTAT -> GCCATCGCTCGATAGTATT
AGGATTTTAGCGCGTCGAT -> GGATTTTAGCGCGTCGATA
CACAAGTAGTGTGGAGTTT -> ACAAGTAGTGTGGAGTTTC
CTCCAACGAAGGCGCGGCG -> TCCAACGAAGGCGCGGCGA
CTTAAGAGCCAAGGATTTT -> TTAAGAGCCAAGGATTTTA
TTTTGCGACCCACTCCCTT -> TTTGCGACCCACTCCCTTG
ATGGTGGGAACACAAGGTA -> TGGTGGGAACACAAGGTAC
TCAGCGCTAGACCAGATGG -> CAGCGCTAGACCAGATGGC
ATAATACGCGGCAGGTTGA -> TAATACGCGGCAGGTTGAT
GTCCAACCCATCAGCATAC -> TCCAACCCATCAGCATACC
TTGGTCCGTACTCCCCACT -> TGGTCCGTACTCCCCACTC
GCACAAGTAGTGTGGAGTT -> CACAAGTAGTGTGGAGTTT
TCCGCTCGGTAAGTGGTGG -> CCGCTCGGTAAGTGGTGGT
GATCACGGAAAATGTAGAA -> ATCACGGAAAATGTAGAAA
CGCGACAAAGCCGGGGCTT -> GCGACAAAGCCGGGGCTTG
GTTCGGGGATTTGCCCCTC -> TTCGGGGATTTGCCCCTCG
CGTTCGGGGATTTGCCCCT -> GTTCGGGGATTTGCCCCTC
TTTGAATTTTGCGACCCAC -> TTGAATTTTGCGACCCACT
CATCTGCGTACAGGTGAAT -> ATCTGCGTACAGGTGAATG
CGATCTTGAAACGGGCAAG -> GATCTTGAAACGGGCAAGA
ACAATTCTTCCCTTGGCTA -> CAATTCTTCCCTTGGCTAA
AGAGCCAAGGATTTTAGCG -> GAGCCAAGGATTTTAGCGC
GTGCAGGAAACAAAGCGGC -> TGCAGGAAACAAAGCGGCC
TGTCCGTTCATACGGTTGC -> GTCCGTTCATACGGTTGCT
GTGGCACTGGCCGGGGCGG -> TGGCACTGGCCGGGGCGGC
GAAATAGGAGGAGGGGACT -> AAATAGGAGGAGGGGACTG
CGTTCATACGGTTGCTTTT -> GTTCATACGGTTGCTTTTG
TCTCAACGCCTCTGCAAAA -> CTCAACGCCTCTGCAAAAC
TGAGACATCAACTCACGGA -> GAGACATCAACTCACGGAG
AGACATCTCCGTGAAACGC -> GACATCTCCGTGAAACGCC
TGATGTGCAGTAAGCCACT -> GATGTGCAGTAAGCCACTA
ACGGGCGAAGAAGTATATT -> CGGGCGAAGAAGTATATTC
TACGGTTGCTTTTGGGGGG -> ACGGTTGCTTTTGGGGGGC
TTGATGTGCAGTAAGCCAC -> TGATGTGCAGTAAGCCACT
GTCTATTCGATCTTGAAAC -> TCTATTCGATCTTGAAACG
TGGACCCCCAGAGGGTGTC -> GGACCCCCAGAGGGTGTCA
GAACTTAGTAGGTCTAGGG -> AACTTAGTAGGTCTAGGGC
ACAGTTGGTAGATGTTAAG -> CAGTTGGTAGATGTTAAGG
ATAGACATCTCCGTGAAAC -> TAGACATCTCCGTGAAACG
CACATGGCAAAGCAGGCGA -> ACATGGCAAAGCAGGCGAT
TACCAAGGCCGTTATATTT -> ACCAAGGCCGTTATATTTA
ACGGACATGGTGGGAACAC -> CGGACATGGTGGGAACACA
CCCCCCATATCAGCGAATC -> CCCCCATATCAGCGAATCC
CGATTCCCTAGATGGCGTC -> GATTCCCTAGATGGCGTCT
TATTTATTTGAATTTTGCG -> ATTTATTTGAATTTTGCGA
CACGGAGCTGACGCCCCTC -> ACGGAGCTGACGCCCCTCC
TCCTCATAACCTATGCCTT -> CCTCATAACCTATGCCTTG
CTCCAGTACAAATGCCCCG -> TCCAGTACAAATGCCCCGC
TCGTTTTATCGCGCAGCCG -> CGTTTTATCGCGCAGCCGC
TAGGACCTTAAGTGCTAAT -> AGGACCTTAAGTGCTAATC
CGATTGGACCCCCAGAGGG -> GATTGGACCCCCAGAGGGT
GGCCGTTATATTTATTTGC -> GCCGTTATATTTATTTGCT
GACTGTCACACAGATGGAA -> ACTGTCACACAGATGGAAG
AAGATCACGGAAAATGTAG -> AGATCACGGAAAATGTAGA
GGGTGGTCGACACTACCCT -> GGTGGTCGACACTACCCTA
TGCGTTCCCTGAACCGGCG -> GCGTTCCCTGAACCGGCGA
GACTCCAACTTGAGAACTA -> ACTCCAACTTGAGAACTAG
GGTGAACGGACATGGTGGG -> GTGAACGGACATGGTGGGA
CTTTGTGTTGCCCCGTGCG -> TTTGTGTTGCCCCGTGCGG
TCGGTAAGTGGTGGTCGAA -> CGGTAAGTGGTGGTCGAAT
TCAACATCCGTCTCATGAT -> CAACATCCGTCTCATGATA
TCACCTGAACATCTCCCCC -> CACCTGAACATCTCCCCCA
CCACTCCCTTGTAGGACCT -> CACTCCCTTGTAGGACCTC, CACTCCCTTGTAGGACCTG, CACTCCCTTGTAGGACCTG, CACTCCCTTGTAGGACCTT
GTGTCCCAACTATTGAATC -> TGTCCCAACTATTGAATCT
TGGAAGCATGAAGGCCTGA -> GGAAGCATGAAGGCCTGAC
TCGACAGTTGGTAGATGTT -> CGACAGTTGGTAGATGTTA
GGACCTGTAGCACCGTTCA -> GACCTGTAGCACCGTTCAA
TAAAAGTGCGAAAGTGAAA -> AAAAGTGCGAAAGTGAAAA
ATTTATTTGAATTTTGCGA -> TTTATTTGAATTTTGCGAC
TTCATTCTGGTGGGTTGAG -> TCATTCTGGTGGGTTGAGG
TAATTTCCTTTGTTACAGC -> AATTTCCTTTGTTACAGCA
GAAGTATATTCTGGTACTG -> AAGTATATTCTGGTACTGA
CCGCAGTGCGTTGCTAAAA -> CGCAGTGCGTTGCTAAAAC
CCGGGGCTTGCTCCCGACC -> CGGGGCTTGCTCCCGACCA
AGCATAACGTAGCTGGACT -> GCATAACGTAGCTGGACTC
GGAATCCGAACACCCCTTA -> GAATCCGAACACCCCTTAA
ACGGGCAAGAGGCAGATTC -> CGGGCAAGAGGCAGATTCG
TGCGGGTGTCAGGTTTCGA -> GCGGGTGTCAGGTTTCGAC
AATTTACGGGCGAAGAAGT -> ATTTACGGGCGAAGAAGTA
AGTAATTGAGACATCAACT -> GTAATTGAGACATCAACTC
CGCTGAGGGGCACCAACAC -> GCTGAGGGGCACCAACACA
CTTTACAATTGGATCACAA -> TTTACAATTGGATCACAAA
TTGCACAAGTAGTGTGGAG -> TGCACAAGTAGTGTGGAGT
ACTGTCACACAGATGGAAG -> CTGTCACACAGATGGAAGC
CACTAAGCGTTAAGAACAA -> ACTAAGCGTTAAGAACAAT
TTTGAGAACCGGTTTGCAG -> TTGAGAACCGGTTTGCAGT
CAGGAAACAAAGCGGCCGC -> AGGAAACAAAGCGGCCGCA
CCGCTCGCATAATGAACTT -> CGCTCGCATAATGAACTTA
TACTTATAATACGCGGCAG -> ACTTATAATACGCGGCAGG
CCCTAGCTCTGTGACCCCC -> CCTAGCTCTGTGACCCCCC
ACGTCGCTACTGTCCAATG -> CGTCGCTACTGTCCAATGC
TTCTGGTGGGTTGAGGGTC -> TCTGGTGGGTTGAGGGTCC
CGATAGGGGTGGTCGACAC -> GATAGGGGTGGTCGACACT
GGAGAGGCCCACATGGCAA -> GAGAGGCCCACATGGCAAA
TGGATCACAAAAACCCGTG -> GGATCACAAAAACCCGTGT
TCCCTAGATGGCGTCTCAG -> CCCTAGATGGCGTCTCAGT
CCTGAACCGGCGAGCATTC -> CTGAACCGGCGAGCATTCT
TATGCCTTGCCTGGAGTAT -> ATGCCTTGCCTGGAGTATG
GCCCCGCACCCTTCCAAAC -> CCCCGCACCCTTCCAAACC
CACAAAAACCCGTGTATTT -> ACAAAAACCCGTGTATTTG
GATGCGTCGTTGCGTACCT -> ATGCGTCGTTGCGTACCTC
GAGAACTAGTTCAACTCAC -> AGAACTAGTTCAACTCACT
CGGACATGGTGGGAACACA -> GGACATGGTGGGAACACAA
CCCCATATCAGCGAATCCG -> CCCATATCAGCGAATCCGT
CAATCATAAGCCAGTGACC -> AATCATAAGCCAGTGACCT
CATAACGTAGCTGGACTCC -> ATAACGTAGCTGGACTCCA
TGTAGGACCTGTAGCACCG -> GTAGGACCTGTAGCACCGT
AGTGAGCCAAATGGCCGTT -> GTGAGCCAAATGGCCGTTA
GGCTAATGTCCGTTCATAC -> GCTAATGTCCGTTCATACG
TTTAGCGCGTCGATAGGGG -> TTAGCGCGTCGATAGGGGT
TATGGGCGCGACAAAGCCG -> ATGGGCGCGACAAAGCCGG
GTACTTGATGTGCAGTAAG -> TACTTGATGTGCAGTAAGC
CACGTCGCTACTGTCCAAT -> ACGTCGCTACTGTCCAATG
CCCATATCAGCGAATCCGT -> CCATATCAGCGAATCCGTG
ACTGGGTGTCCCAACTATT -> CTGGGTGTCCCAACTATTG
CGGCGAGCATTCTAAAAGT -> GGCGAGCATTCTAAAAGTG
GAACCGGTTTGCAGTTCAA -> AACCGGTTTGCAGTTCAAA
CCTGGAGTATGGGCGCGAC -> CTGGAGTATGGGCGCGACA
CCGAAGTGAGCCAAATGGC -> CGAAGTGAGCCAAATGGCC
TGGAGAGTGACCGACAAAG -> GGAGAGTGACCGACAAAGT
TGAAAAAGATTGCACAAGT -> GAAAAAGATTGCACAAGTA
CAATTCTTCCCTTGGCTAA -> AATTCTTCCCTTGGCTAAT
TTAGGGCGTTCAACATCCG -> TAGGGCGTTCAACATCCGT
TTGATTCATGCTGCCCTAA -> TGATTCATGCTGCCCTAAG
CTCGCATAATGAACTTAGT -> TCGCATAATGAACTTAGTA
GTGTTCACTGGCTTCTCAA -> TGTTCACTGGCTTCTCAAC
GCTCCAACGAAGGCGCGGC -> CTCCAACGAAGGCGCGGCG
TCTATATCTTTGTGTTGCC -> CTATATCTTTGTGTTGCCC
CTATTGAATCTCCGAAGTG -> TATTGAATCTCCGAAGTGA
TGCTTTTGGGGGGCCGTTA -> GCTTTTGGGGGGCCGTTAT
CACGGTGCGCCTGCGCAAG -> ACGGTGCGCCTGCGCAAGA
ATAGTATTCATTCTGGTGG -> TAGTATTCATTCTGGTGGG
CACCGCAAAGTTGGAGAGT -> ACCGCAAAGTTGGAGAGTG
GAGTATTACCTGCGTTCCC -> AGTATTACCTGCGTTCCCT
CGCAGCCGCTCTACTTGAC -> GCAGCCGCTCTACTTGACT
TTGATGCGTCGTTGCGTAC -> TGATGCGTCGTTGCGTACC
GGTCGACACTACCCTAGCT -> GTCGACACTACCCTAGCTC
GGCCTGACTTTCGTGGCAC -> GCCTGACTTTCGTGGCACT
AAGCATAACGTAGCTGGAC -> AGCATAACGTAGCTGGACT
CAAAAACCCGTGTATTTGA -> AAAAACCCGTGTATTTGAG
AGCGGCCGCACTGTCAATG -> GCGGCCGCACTGTCAATGC
CTGATTCCTTTGCTGATTG -> TGATTCCTTTGCTGATTGC
GACAGTTGGTAGATGTTAA -> ACAGTTGGTAGATGTTAAG
CCTTTGCTGATTGCTAAGG -> CTTTGCTGATTGCTAAGGA
AAGCGGTACGTCAAGTGTA -> AGCGGTACGTCAAGTGTAC
TTCAAAACGGACAAAAGCG -> TCAAAACGGACAAAAGCGG
TTGCGACCCACTCCCTTGT -> TGCGACCCACTCCCTTGTA
ATAATGAACTTAGTAGGTC -> TAATGAACTTAGTAGGTCT
CCCCCAGGGCTTATTATAT -> CCCCAGGGCTTATTATATG
TGGACGTAAATCCTGGTCT -> GGACGTAAATCCTGGTCTT
GCCCCGTGCGGGTGTCAGG -> CCCCGTGCGGGTGTCAGGT
GGCGCGACAAAGCCGGGGC -> GCGCGACAAAGCCGGGGCT
TTTCGACAGTTGGTAGATG -> TTCGACAGTTGGTAGATGT
CCGTTATATTTATTTGGTC -> CGTTATATTTATTTGGTCC
ACGTATGTTTTGCGATCCC -> CGTATGTTTTGCGATCCCG
GTACTCCCCACTCCCTTGT -> TACTCCCCACTCCCTTGTA
GCACTGTCAATGCTGCATC -> CACTGTCAATGCTGCATCT
GGCCCTCAGCGCTAGACCA -> GCCCTCAGCGCTAGACCAG
GGGGATTGGACGTAAATCC -> GGGATTGGACGTAAATCCT
AATGCGGGAATCCGAACAC -> ATGCGGGAATCCGAACACC
CCCCACTCCCTTGTAGGAC -> CCCACTCCCTTGTAGGACC
CCGCAAAGTTGGAGAGTGA -> CGCAAAGTTGGAGAGTGAC
GAGGCAGATTCGGGTGAAC -> AGGCAGATTCGGGTGAACG
GCCGTTATATTTATTTGTG -> CCGTTATATTTATTTGTGC
GACCAGATGGCCATCGCTC -> ACCAGATGGCCATCGCTCG
ATTGGATCACAAAAACCCG -> TTGGATCACAAAAACCCGT
TTTCCCTTGCCTAGATGTA -> TTCCCTTGCCTAGATGTAC
CCCTAGATGGCGTCTCAGT -> CCTAGATGGCGTCTCAGTG
CACGGAGTGAATTTACGGG -> ACGGAGTGAATTTACGGGC
TACTCCCCACTCCCTTGTA -> ACTCCCCACTCCCTTGTAG
AACCGGCGAGCATTCTAAA -> ACCGGCGAGCATTCTAAAA
GAGGAAGCCATACCGTGAT -> AGGAAGCCATACCGTGATC
CGCAAGATGGAAAAAGTGT -> GCAAGATGGAAAAAGTGTT
GTAATTGAGACATCAACTC -> TAATTGAGACATCAACTCA
TTGCAGTTCAAAGATAGAC -> TGCAGTTCAAAGATAGACA
ACATCTCCCCCAGGGCTTA -> CATCTCCCCCAGGGCTTAT
AGTGAAAAAGATTGCACAA -> GTGAAAAAGATTGCACAAG
ACGCTGGCGCCGCAGTGCG -> CGCTGGCGCCGCAGTGCGT
GAATTTTGCGACCCACTCC -> AATTTTGCGACCCACTCCC
ACTAAGCGTTAAGAACAAT -> CTAAGCGTTAAGAACAATC
GTACCTCTATATCTTTGTG -> TACCTCTATATCTTTGTGT
TGTTTCCCTTGCCTAGATG -> GTTTCCCTTGCCTAGATGT
CGCGTCGATAGGGGTGGTC -> GCGTCGATAGGGGTGGTCG
CACTGTCAATGCTGCATCT -> ACTGTCAATGCTGCATCTG
CGGGGATTTGCCCCTCGAT -> GGGGATTTGCCCCTCGATT
GCAAAACCCTCTTGCCTAG -> CAAAACCCTCTTGCCTAGT
AAGATTGCACAAGTAGTGT -> AGATTGCACAAGTAGTGTG
CCATTCTAGCGGAAGGCGT -> CATTCTAGCGGAAGGCGTG
TTCTGGTACTGATTCCTTT -> TCTGGTACTGATTCCTTTG
GCTCGCATAATGAACTTAG -> CTCGCATAATGAACTTAGT
CTACTTGTGAGGAAGCCAT -> TACTTGTGAGGAAGCCATA
TGGAGTTTCCCACTAAGAC -> GGAGTTTCCCACTAAGACT
ATACGATGGGTTAGTATCT -> TACGATGGGTTAGTATCTT
CACAAGGTACTCCGCTCGC -> ACAAGGTACTCCGCTCGCA
TAGGACCTGGGACTCCAAC -> AGGACCTGGGACTCCAACT
TCTAGCGGAAGGCGTGCGT -> CTAGCGGAAGGCGTGCGTC
TAGCACCGCAAAGTTGGAG -> AGCACCGCAAAGTTGGAGA
GTTTCGACAGTTGGTAGAT -> TTTCGACAGTTGGTAGATG
CCCTCCTAGACGCTGGCGC -> CCTCCTAGACGCTGGCGCC
GAACGGCGTCAGTACGTAT -> AACGGCGTCAGTACGTATG
TAGCACCGTTCAAAACGGA -> AGCACCGTTCAAAACGGAC
ATACGCGGCAGGTTGATGC -> TACGCGGCAGGTTGATGCG
AGATGTTAAGGTATGCGCT -> GATGTTAAGGTATGCGCTG
GTTGATGCGTCGTTGCGTA -> TTGATGCGTCGTTGCGTAC
GTCTAGGGCGATACCCGGA -> TCTAGGGCGATACCCGGAG
GCGTCGATAGGGGTGGTCG -> CGTCGATAGGGGTGGTCGA
TCCGTCTCATGATAAGCGG -> CCGTCTCATGATAAGCGGT
AGACGCTGGCGCCGCAGTG -> GACGCTGGCGCCGCAGTGC
GTGTGGAGTTTCCCACTAA -> TGTGGAGTTTCCCACTAAG
TATAATACGCGGCAGGTTG -> ATAATACGCGGCAGGTTGA
CGGTGTCCATCCCGTTTTC -> GGTGTCCATCCCGTTTTCG
CGAGGTCACGTCGCTACTG -> GAGGTCACGTCGCTACTGT
TGCGACCCACTCCCTTGTA -> GCGACCCACTCCCTTGTAG
GCCGCTCTACTTGACTGTC -> CCGCTCTACTTGACTGTCA
ATCCGAACACCCCTTAAGA -> TCCGAACACCCCTTAAGAG
CTTTGTTACAGCAATCATA -> TTTGTTACAGCAATCATAA
TCCGAACACCCCTTAAGAG -> CCGAACACCCCTTAAGAGC
GCGCTGAGGGGCACCAACA -> CGCTGAGGGGCACCAACAC
ATGCCTTGCCTGGAGTATG -> TGCCTTGCCTGGAGTATGG
TTGTGCAGAGAATTCCACT -> TGTGCAGAGAATTCCACTC
CACCGTTCAAAACGGACAA -> ACCGTTCAAAACGGACAAA
CGTTTTATCGCGCAGCCGC -> GTTTTATCGCGCAGCCGCT
ACGCCCTAGTAATTGAGAC -> CGCCCTAGTAATTGAGACA
CATTTTGAGAACCGGTTTG -> ATTTTGAGAACCGGTTTGC
TCAACTCACTGGGTGTCCC -> CAACTCACTGGGTGTCCCA
GTTCCCTGAACCGGCGAGC -> TTCCCTGAACCGGCGAGCA
CATGAAGGCCTGACTTTCG -> ATGAAGGCCTGACTTTCGT
TTGCTTTTGGGGGGCCGTT -> TGCTTTTGGGGGGCCGTTA
TGCTAAAACTCACCTGAAC -> GCTAAAACTCACCTGAACA
CGAAAGTGAAAAAGATTGC -> GAAAGTGAAAAAGATTGCA
GTAGGACCTGGGACTCCAA -> TAGGACCTGGGACTCCAAC
CTTGACTATTTACTTATAA -> TTGACTATTTACTTATAAT
CGTCCTCATAACCTATGCC -> GTCCTCATAACCTATGCCT
TTGTAGGACCTGTAGCACC -> TGTAGGACCTGTAGCACCG
GCACTGGCCGGGGCGGCCG -> CACTGGCCGGGGCGGCCGT
AGGGCTTATTATATGTGCG -> GGGCTTATTATATGTGCGG
GGGCGAAGAAGTATATTCT -> GGCGAAGAAGTATATTCTG
CGCAAAGTTGGAGAGTGAC -> GCAAAGTTGGAGAGTGACC
CGTTCAAAACGGACAAAAG -> GTTCAAAACGGACAAAAGC
ACTCACGGAGCTGACGCCC -> CTCACGGAGCTGACGCCCC
GTATCTTAGGGCGTTCAAC -> TATCTTAGGGCGTTCAACA
ATGCCCCACTGGCTCCAAC -> TGCCCCACTGGCTCCAACG
TACTTGACTGTCACACAGA -> ACTTGACTGTCACACAGAT
AGTGTGGAGTTTCCCACTA -> GTGTGGAGTTTCCCACTAA
TTCAACATCCGTCTCATGA -> TCAACATCCGTCTCATGAT
TGCTAAGGAATACGATGGG -> GCTAAGGAATACGATGGGT
GGTTAGTATCTTAGGGCGT -> GTTAGTATCTTAGGGCGTT
GGCGTCTCAGTGTCTATTC -> GCGTCTCAGTGTCTATTCG
AACGGGCAAGAGGCAGATT -> ACGGGCAAGAGGCAGATTC
ATCTGGAGAACGGCGTCAG -> TCTGGAGAACGGCGTCAGT
CCTGGTCTTGACTATTTAC -> CTGGTCTTGACTATTTACT
AGCCGGGGCTTGCTCCCGA -> GCCGGGGCTTGCTCCCGAC
CCCAAAAGCATAACGTAGC -> CCAAAAGCATAACGTAGCT
AGTATTACCTGCGTTCCCT -> GTATTACCTGCGTTCCCTG
GGAGCTTCACACGGTGCGC -> GAGCTTCACACGGTGCGCC
CCATACCGTGATCTGGAGA -> CATACCGTGATCTGGAGAA
CCCTCTTGCCTAGTACACA -> CCTCTTGCCTAGTACACAC
GAGTGAATTTACGGGCGAA -> AGTGAATTTACGGGCGAAG
ATAGCCAGGCAACGGTTTT -> TAGCCAGGCAACGGTTTTC
TTAGTCACGGAGTGAATTT -> TAGTCACGGAGTGAATTTA
CGGCGAACTACTTGTGAGG -> GGCGAACTACTTGTGAGGA
CTTGGCTAATGTCCGTTCA -> TTGGCTAATGTCCGTTCAT
CATTCTAAAAGTGCGAAAG -> ATTCTAAAAGTGCGAAAGT
TGGTCGAATGCTCTGGGGA -> GGTCGAATGCTCTGGGGAT
TAAGGAATACGATGGGTTA -> AAGGAATACGATGGGTTAG
TTTTGGGGGGCCGTTATAT -> TTTGGGGGGCCGTTATATT
GGAAGGCGTGCGTCATAGC -> GAAGGCGTGCGTCATAGCC
GCAAAGTTGGAGAGTGACC -> CAAAGTTGGAGAGTGACCG
GGTCTTGACTATTTACTTA -> GTCTTGACTATTTACTTAT
GATAAGCGGTACGTCAAGT -> ATAAGCGGTACGTCAAGTG
AACAAAGCGGCCGCACTGT -> ACAAAGCGGCCGCACTGTC
CGACCATTTTGAGAACCGG -> GACCATTTTGAGAACCGGT
TCCGTACTCCCCACTCCCT -> CCGTACTCCCCACTCCCTT
GGGCGTTCAACATCCGTCT -> GGCGTTCAACATCCGTCTC
GCCGTTATATTTATTTGGT -> CCGTTATATTTATTTGGTC
GGTTGAGGGTCCACGCCCA -> GTTGAGGGTCCACGCCCAA
ACAGCAATCATAAGCCAGT -> CAGCAATCATAAGCCAGTG
GGAGTATGGGCGCGACAAA -> GAGTATGGGCGCGACAAAG
CCGTTTTCGAGGTCACGTC -> CGTTTTCGAGGTCACGTCG
GCGGCAGGTTGATGCGTCG -> CGGCAGGTTGATGCGTCGT
GTCCATCCCGTTTTCGAGG -> TCCATCCCGTTTTCGAGGT
GCCGCACTGTCAATGCTGC -> CCGCACTGTCAATGCTGCA
TTTGTGCAGAGAATTCCAC -> TTGTGCAGAGAATTCCACT
AGTTGGTAGATGTTAAGGT -> GTTGGTAGATGTTAAGGTA
AGAGTGACCGACAAAGTTC -> GAGTGACCGACAAAGTTCC
AGGTCACGTCGCTACTGTC -> GGTCACGTCGCTACTGTCC
GGGCTTGCTCCCGACCATT -> GGCTTGCTCCCGACCATTT
ACAGATGGAAGCATGAAGG -> CAGATGGAAGCATGAAGGC
ATCCGTCTCATGATAAGCG -> TCCGTCTCATGATAAGCGG
CGCCCAAAAGCATAACGTA -> GCCCAAAAGCATAACGTAG
TTTGCGATCCCGGCTAGAT -> TTGCGATCCCGGCTAGATC
CGCTGGCGCCGCAGTGCGT -> GCTGGCGCCGCAGTGCGTT
TTCGGGTGAACGGACATGG -> TCGGGTGAACGGACATGGT
CGGGTGTCAGGTTTCGACA -> GGGTGTCAGGTTTCGACAG
TGCCTGGAGTATGGGCGCG -> GCCTGGAGTATGGGCGCGA
TCGGGTGAACGGACATGGT -> CGGGTGAACGGACATGGTG
AACCGGTTTGCAGTTCAAA -> ACCGGTTTGCAGTTCAAAG
AGGCCTTTACAATTGGATC -> GGCCTTTACAATTGGATCA
TAACGTAGCTGGACTCCAG -> AACGTAGCTGGACTCCAGT
ATCTTTGTGTTGCCCCGTG -> TCTTTGTGTTGCCCCGTGC
GATGTTAAGGTATGCGCTG -> ATGTTAAGGTATGCGCTGA
GCGGCCGCACTGTCAATGC -> CGGCCGCACTGTCAATGCT
TCGGGGATTTGCCCCTCGA -> CGGGGATTTGCCCCTCGAT
TCCATCCCGTTTTCGAGGT -> CCATCCCGTTTTCGAGGTC
TCACACAGATGGAAGCATG -> CACACAGATGGAAGCATGA
CACAGATGGAAGCATGAAG -> ACAGATGGAAGCATGAAGG
GCGCGTCGATAGGGGTGGT -> CGCGTCGATAGGGGTGGTC
AACGTAGCTGGACTCCAGT -> ACGTAGCTGGACTCCAGTA
GCAACGGTTTTCCTAATTT -> CAACGGTTTTCCTAATTTC
GTTACAGCAATCATAAGCC -> TTACAGCAATCATAAGCCA
TCCTGGTCTTGACTATTTA -> CCTGGTCTTGACTATTTAC
GCGACAAAGCCGGGGCTTG -> CGACAAAGCCGGGGCTTGC
TTCCTTTGCTGATTGCTAA -> TCCTTTGCTGATTGCTAAG
CTCTGGGGATTGGACGTAA -> TCTGGGGATTGGACGTAAA
GTCGACACTACCCTAGCTC -> TCGACACTACCCTAGCTCT
AAACCGTCCTCATAACCTA -> AACCGTCCTCATAACCTAT
GACCTATGATGAGGCGCAT -> ACCTATGATGAGGCGCATA
AACTTAGTAGGTCTAGGGC -> ACTTAGTAGGTCTAGGGCG
TGACGCCCCTCCTAGACGC -> GACGCCCCTCCTAGACGCT
AGCTTCACACGGTGCGCCT -> GCTTCACACGGTGCGCCTG
CTAAAACTCACCTGAACAT -> TAAAACTCACCTGAACATC
TGCGATCCCGGCTAGATCA -> GCGATCCCGGCTAGATCAA
ATGTGCAGTAAGCCACTAA -> TGTGCAGTAAGCCACTAAG
GCTCGATAGTATTCATTCT -> CTCGATAGTATTCATTCTG
AGTGAATTTACGGGCGAAG -> GTGAATTTACGGGCGAAGA
TCTTAGGGCGTTCAACATC -> CTTAGGGCGTTCAACATCC
TACACACGTATGTTTTGCG -> ACACACGTATGTTTTGCGA
CCTCTGCAAAACCCTCTTG -> CTCTGCAAAACCCTCTTGC
TCAGCGAATCCGTGCAGGA -> CAGCGAATCCGTGCAGGAA
GTATATTCTGGTACTGATT -> TATATTCTGGTACTGATTC
TGCGCAAGATGGAAAAAGT -> GCGCAAGATGGAAAAAGTG
TAGGGCGATACCCGGAGCA -> AGGGCGATACCCGGAGCAG
GACATCAACTCACGGAGCT -> ACATCAACTCACGGAGCTG
TCCCGTTTTCGAGGTCACG -> CCCGTTTTCGAGGTCACGT
TGCCCTAAGGGGACGAATT -> GCCCTAAGGGGACGAATTC
CAGGGCTTATTATATGTGC -> AGGGCTTATTATATGTGCG
CATTCTAGCGGAAGGCGTG -> ATTCTAGCGGAAGGCGTGC
ATGCGCTGAGGGGCACCAA -> TGCGCTGAGGGGCACCAAC
GCCTAGTACACACGTATGT -> CCTAGTACACACGTATGTT
AGGCCCACATGGCAAAGCA -> GGCCCACATGGCAAAGCAG
ACGGCGTCAGTACGTATGT -> CGGCGTCAGTACGTATGTC
TCACAAAAACCCGTGTATT -> CACAAAAACCCGTGTATTT
ACTCCAACTTGAGAACTAG -> CTCCAACTTGAGAACTAGT
TCGAATGCTCTGGGGATTG -> CGAATGCTCTGGGGATTGG
TCCAGTACAAATGCCCCGC -> CCAGTACAAATGCCCCGCA
CCAATGCGGGAATCCGAAC -> CAATGCGGGAATCCGAACA
GATCCCGGCTAGATCAAGA -> ATCCCGGCTAGATCAAGAA
CAGATGGCCATCGCTCGAT -> AGATGGCCATCGCTCGATA
CTATATCTTTGTGTTGCCC -> TATATCTTTGTGTTGCCCC
ACTTGTGAGGAAGCCATAC -> CTTGTGAGGAAGCCATACC
GGCGCCGCAGTGCGTTGCT -> GCGCCGCAGTGCGTTGCTA
AGGGCGATACCCGGAGCAG -> GGGCGATACCCGGAGCAGG
ATTTCCTTTGTTACAGCAA -> TTTCCTTTGTTACAGCAAT
GGGCCGTTATATTTATTTG -> GGCCGTTATATTTATTTGG
TGCACAAGTAGTGTGGAGT -> GCACAAGTAGTGTGGAGTT
GGAAAAAGTGTTCACTGGC -> GAAAAAGTGTTCACTGGCT
TGGTCCGTACTCCCCACTC -> GGTCCGTACTCCCCACTCC
GAAACGGGCAAGAGGCAGA -> AAACGGGCAAGAGGCAGAT
TCTTCCCTTGGCTAATGTC -> CTTCCCTTGGCTAATGTCC
GACGCCCCTCCTAGACGCT -> ACGCCCCTCCTAGACGCTG
ATTTGCTAGCCGGTAGCCA -> TTTGCTAGCCGGTAGCCAC
GGACTCCAACTTGAGAACT -> GACTCCAACTTGAGAACTA
TGCGGGAATCCGAACACCC -> GCGGGAATCCGAACACCCC
CAAGATCACGGAAAATGTA -> AAGATCACGGAAAATGTAG
TACTCCGCTCGCATAATGA -> ACTCCGCTCGCATAATGAA
TCACTGGCTTCTCAACGCC -> CACTGGCTTCTCAACGCCT
TGCCCCACTGGCTCCAACG -> GCCCCACTGGCTCCAACGA
CCCCCCCCATATCAGCGAA -> CCCCCCCATATCAGCGAAT
GGAAACAAAGCGGCCGCAC -> GAAACAAAGCGGCCGCACT
CGACCCACTCCCTTGTAGG -> GACCCACTCCCTTGTAGGA
GACAAAGTTCCGGTGTCCA -> ACAAAGTTCCGGTGTCCAT
CAACGGTTTTCCTAATTTC -> AACGGTTTTCCTAATTTCC
TCAGTACGTATGTCCAACC -> CAGTACGTATGTCCAACCC
GAGAATTCCACTCCCTTGT -> AGAATTCCACTCCCTTGTA
TCGATAGTATTCATTCTGG -> CGATAGTATTCATTCTGGT
AATGCCCCGCACCCTTCCA -> ATGCCCCGCACCCTTCCAA
GCTCCCGACCATTTTGAGA -> CTCCCGACCATTTTGAGAA
TCCCTTGGCTAATGTCCGT -> CCCTTGGCTAATGTCCGTT
CCTAGTACACACGTATGTT -> CTAGTACACACGTATGTTT
GCACCCTTCCAAACCGTCC -> CACCCTTCCAAACCGTCCT
CGAACTACTTGTGAGGAAG -> GAACTACTTGTGAGGAAGC
GAGGGGCACCAACACACTG -> AGGGGCACCAACACACTGG
AGCATTCTAAAAGTGCGAA -> GCATTCTAAAAGTGCGAAA
GTGAATTTACGGGCGAAGA -> TGAATTTACGGGCGAAGAA
TGATGCGTCGTTGCGTACC -> GATGCGTCGTTGCGTACCT
TTCACTGGCTTCTCAACGC -> TCACTGGCTTCTCAACGCC
CTGTGACCCCCCCCATATC -> TGTGACCCCCCCCATATCA
AGGAAACAAAGCGGCCGCA -> GGAAACAAAGCGGCCGCAC
GAGGTTCCATTCTAGCGGA -> AGGTTCCATTCTAGCGGAA
AAAACCCGTGTATTTGAGG -> AAACCCGTGTATTTGAGGA
CGGCCGCACTGTCAATGCT -> GGCCGCACTGTCAATGCTG
CAGTGCGTTGCTAAAACTC -> AGTGCGTTGCTAAAACTCA
GTTTCCCACTAAGACTTAG -> TTTCCCACTAAGACTTAGA
CGTACCTCTATATCTTTGT -> GTACCTCTATATCTTTGTG
TACCAAGATCACGGAAAAT -> ACCAAGATCACGGAAAATG
TCCCTGAACCGGCGAGCAT -> CCCTGAACCGGCGAGCATT
CCACTGGCTCCAACGAAGG -> CACTGGCTCCAACGAAGGC
TGGTCTTGACTATTTACTT -> GGTCTTGACTATTTACTTA
TTTTCGAGGTCACGTCGCT -> TTTCGAGGTCACGTCGCTA
AATTTTGCGACCCACTCCC -> ATTTTGCGACCCACTCCCT
TAGGACCTGTAGCACCGTT -> AGGACCTGTAGCACCGTTC
CAGCTAGTGTGCCTGTTTC -> AGCTAGTGTGCCTGTTTCC
TAAGTGCTAATCGCAGGTT -> AAGTGCTAATCGCAGGTTA
TATGTGCGGACAATTCTTC -> ATGTGCGGACAATTCTTCC
TGGTACTGATTCCTTTGCT -> GGTACTGATTCCTTTGCTG
GATTTGCCCCTCGATTCCC -> ATTTGCCCCTCGATTCCCT
TCTTGCCTAGTACACACGT -> CTTGCCTAGTACACACGTA
TAGATGTACCAAGGCCGTT -> AGATGTACCAAGGCCGTTA
GCCATACCGTGATCTGGAG -> CCATACCGTGATCTGGAGA
TTTATTTGGTCCGTACTCC -> TTATTTGGTCCGTACTCCC
ATAGGGGTGGTCGACACTA -> TAGGGGTGGTCGACACTAC
TTGTGAGGAAGCCATACCG -> TGTGAGGAAGCCATACCGT
ACGGTGCGCCTGCGCAAGA -> CGGTGCGCCTGCGCAAGAT
GCGTGCGTCATAGCCAGGC -> CGTGCGTCATAGCCAGGCA
TTCGTGGCACTGGCCGGGG -> TCGTGGCACTGGCCGGGGC
TATATTTATTTGGTCCGTA -> ATATTTATTTGGTCCGTAC
CATTCTGGTGGGTTGAGGG -> ATTCTGGTGGGTTGAGGGT
GAGGCGCATAGCACCGCAA -> AGGCGCATAGCACCGCAAA
TGTTTTGCGATCCCGGCTA -> GTTTTGCGATCCCGGCTAG
TCCTTTGCTGATTGCTAAG -> CCTTTGCTGATTGCTAAGG
AGGCCTGACTTTCGTGGCA -> GGCCTGACTTTCGTGGCAC
ACTTATAATACGCGGCAGG -> CTTATAATACGCGGCAGGT
ATGAGGCGCATAGCACCGC -> TGAGGCGCATAGCACCGCA
TGATAAGCGGTACGTCAAG -> GATAAGCGGTACGTCAAGT
GTTCACTGGCTTCTCAACG -> TTCACTGGCTTCTCAACGC
TTGGAGAGTGACCGACAAA -> TGGAGAGTGACCGACAAAG
TGCAAAACCCTCTTGCCTA -> GCAAAACCCTCTTGCCTAG
CATAAGCCAGTGACCTATG -> ATAAGCCAGTGACCTATGA
GTGTGCCTGTTTCCCTTGC -> TGTGCCTGTTTCCCTTGCC
ACTCCCTTGTAGGACCTCA -> CTCCCTTGTAGGACCTCAG
TGAACGGACATGGTGGGAA -> GAACGGACATGGTGGGAAC
ATGATAAGCGGTACGTCAA -> TGATAAGCGGTACGTCAAG
CTCAGCGCTAGACCAGATG -> TCAGCGCTAGACCAGATGG
GTAAATCCTGGTCTTGACT -> TAAATCCTGGTCTTGACTA
CAGTGTCTATTCGATCTTG -> AGTGTCTATTCGATCTTGA
CAGCCGCTCTACTTGACTG -> AGCCGCTCTACTTGACTGT
GCAGGCGATTGGACCCCCA -> CAGGCGATTGGACCCCCAG
TCACGGAAAATGTAGAAAT -> CACGGAAAATGTAGAAATA
ATCGCTCGATAGTATTCAT -> TCGCTCGATAGTATTCATT
ATTTTGAGAACCGGTTTGC -> TTTTGAGAACCGGTTTGCA
TCCGTGCAGGAAACAAAGC -> CCGTGCAGGAAACAAAGCG
GCTAGACCAGATGGCCATC -> CTAGACCAGATGGCCATCG
TAGACCAGATGGCCATCGC -> AGACCAGATGGCCATCGCT
TGAATTTACGGGCGAAGAA -> GAATTTACGGGCGAAGAAG
AAGTGAAAAAGATTGCACA -> AGTGAAAAAGATTGCACAA
AAATGGCCGTTATATTTAT -> AATGGCCGTTATATTTATT
GGCGATTGGACCCCCAGAG -> GCGATTGGACCCCCAGAGG
GTCCTCATAACCTATGCCT -> TCCTCATAACCTATGCCTT
GAAACGCCCTAGTAATTGA -> AAACGCCCTAGTAATTGAG
TAGTTCAACTCACTGGGTG -> AGTTCAACTCACTGGGTGT
GAACCGGCGAGCATTCTAA -> AACCGGCGAGCATTCTAAA
ACACAAGGTACTCCGCTCG -> CACAAGGTACTCCGCTCGC
AGCCAAGGATTTTAGCGCG -> GCCAAGGATTTTAGCGCGT
TACGTATGTCCAACCCATC -> ACGTATGTCCAACCCATCA
ATTCTTCCCTTGGCTAATG -> TTCTTCCCTTGGCTAATGT
GCATCTGTCAGCTAGTGTG -> CATCTGTCAGCTAGTGTGC
TATTTGCTAGCCGGTAGCC -> ATTTGCTAGCCGGTAGCCA
CGGCAGGTTGATGCGTCGT -> GGCAGGTTGATGCGTCGTT
TTTCCTTTGTTACAGCAAT -> TTCCTTTGTTACAGCAATC
GGACCCCCAGAGGGTGTCA -> GACCCCCAGAGGGTGTCAT
GGGGGGCCGTTATATTTAT -> GGGGGCCGTTATATTTATT
ACGTAGCTGGACTCCAGTA -> CGTAGCTGGACTCCAGTAC
GCGTACCTCTATATCTTTG -> CGTACCTCTATATCTTTGT
GATACCCGGAGCAGGGTGG -> ATACCCGGAGCAGGGTGGC
CTAGACCAGATGGCCATCG -> TAGACCAGATGGCCATCGC
TTAGCGCGTCGATAGGGGT -> TAGCGCGTCGATAGGGGTG
ATGTTAAGGTATGCGCTGA -> TGTTAAGGTATGCGCTGAG
CCTTGGCTAATGTCCGTTC -> CTTGGCTAATGTCCGTTCA
GACAAAAGCGGATTGACCA -> ACAAAAGCGGATTGACCAT
TGCGAAAGTGAAAAAGATT -> GCGAAAGTGAAAAAGATTG
AAGTAGTGTGGAGTTTCCC -> AGTAGTGTGGAGTTTCCCA
GTTCCATTCTAGCGGAAGG -> TTCCATTCTAGCGGAAGGC
AAGTATATTCTGGTACTGA -> AGTATATTCTGGTACTGAT
TCACGTCGCTACTGTCCAA -> CACGTCGCTACTGTCCAAT
TTGCTGATTGCTAAGGAAT -> TGCTGATTGCTAAGGAATA
GAGGGGACTGGAGGGTACT -> AGGGGACTGGAGGGTACTT
TCCGGTGTCCATCCCGTTT -> CCGGTGTCCATCCCGTTTT
GACTGGAGGGTACTTGATG -> ACTGGAGGGTACTTGATGT
TCCTAGACGCTGGCGCCGC -> CCTAGACGCTGGCGCCGCA
ATTTGCCCCTCGATTCCCT -> TTTGCCCCTCGATTCCCTA
AGTGGTGGTCGAATGCTCT -> GTGGTGGTCGAATGCTCTG
TAAATCCTGGTCTTGACTA -> AAATCCTGGTCTTGACTAT
ATTCATTCTGGTGGGTTGA -> TTCATTCTGGTGGGTTGAG
CAGATGGAAGCATGAAGGC -> AGATGGAAGCATGAAGGCC
GTACGTATGTCCAACCCAT -> TACGTATGTCCAACCCATC
TTTGCAGTTCAAAGATAGA -> TTGCAGTTCAAAGATAGAC
AAGAGCCAAGGATTTTAGC -> AGAGCCAAGGATTTTAGCG
CGTTATATTTATTTGTGCA -> GTTATATTTATTTGTGCAG
TGCCTTGATTCATGCTGCC -> GCCTTGATTCATGCTGCCC
CACTGGCTTCTCAACGCCT -> ACTGGCTTCTCAACGCCTC
CCTAAGGGGACGAATTCGT -> CTAAGGGGACGAATTCGTT
TATCTTTGTGTTGCCCCGT -> ATCTTTGTGTTGCCCCGTG
CCTATGATGAGGCGCATAG -> CTATGATGAGGCGCATAGC
ACAATTGGATCACAAAAAC -> CAATTGGATCACAAAAACC
AGTGTACGTTCGGGGATTT -> GTGTACGTTCGGGGATTTG
AACGCCCTAGTAATTGAGA -> ACGCCCTAGTAATTGAGAC
CTGGCTTCTCAACGCCTCT -> TGGCTTCTCAACGCCTCTG
CAAATGCCCCGCACCCTTC -> AAATGCCCCGCACCCTTCC
ACGTATGTCCAACCCATCA -> CGTATGTCCAACCCATCAG
ACCGTTCAAAACGGACAAA -> CCGTTCAAAACGGACAAAA
GTGCTAATCGCAGGTTAGT -> TGCTAATCGCAGGTTAGTC
ACGAATTCGTTTTATCGCG -> CGAATTCGTTTTATCGCGC
TGCTCCCGACCATTTTGAG -> GCTCCCGACCATTTTGAGA
GCCTGTTTCCCTTGCCTAG -> CCTGTTTCCCTTGCCTAGA
ATTCTGGTGGGTTGAGGGT -> TTCTGGTGGGTTGAGGGTC
CCTAGATGGCGTCTCAGTG -> CTAGATGGCGTCTCAGTGT
CGGACAATTCTTCCCTTGG -> GGACAATTCTTCCCTTGGC
ATATTCTGGTACTGATTCC -> TATTCTGGTACTGATTCCT
AGCAGGGTGGCCCTCAGCG -> GCAGGGTGGCCCTCAGCGC
CATGCTGCCCTAAGGGGAC -> ATGCTGCCCTAAGGGGACG
CATGATAAGCGGTACGTCA -> ATGATAAGCGGTACGTCAA
CTTATTATATGTGCGGACA -> TTATTATATGTGCGGACAA
CACTGGCCGGGGCGGCCGT -> ACTGGCCGGGGCGGCCGTT
TAAGCGGTACGTCAAGTGT -> AAGCGGTACGTCAAGTGTA
CCCGTGCGGGTGTCAGGTT -> CCGTGCGGGTGTCAGGTTT
CCTGCGCAAGATGGAAAAA -> CTGCGCAAGATGGAAAAAG
TGAGGAAGCCATACCGTGA -> GAGGAAGCCATACCGTGAT
AAGGCGTGCGTCATAGCCA -> AGGCGTGCGTCATAGCCAG
AAATGCCCCGCACCCTTCC -> AATGCCCCGCACCCTTCCA
AAAAACCCGTGTATTTGAG -> AAAACCCGTGTATTTGAGG
CTCATGATAAGCGGTACGT -> TCATGATAAGCGGTACGTC
CCCTGGAGAGGCCCACATG -> CCTGGAGAGGCCCACATGG
CTGAGGGGCACCAACACAC -> TGAGGGGCACCAACACACT
CCTTGCCTAGATGTACCAA -> CTTGCCTAGATGTACCAAG
GAGTGACCGACAAAGTTCC -> AGTGACCGACAAAGTTCCG
AAAGTGCGAAAGTGAAAAA -> AAGTGCGAAAGTGAAAAAG
CTGGCGCCGCAGTGCGTTG -> TGGCGCCGCAGTGCGTTGC
GTCAGCTAGTGTGCCTGTT -> TCAGCTAGTGTGCCTGTTT
GACATGGTGGGAACACAAG -> ACATGGTGGGAACACAAGG
ACTCACCTGAACATCTCCC -> CTCACCTGAACATCTCCCC
CCTCATAACCTATGCCTTG -> CTCATAACCTATGCCTTGC
GTAGCCACTCCCTTGTAGG -> TAGCCACTCCCTTGTAGGA
GTGAGGAAGCCATACCGTG -> TGAGGAAGCCATACCGTGA
GTCAGGTTTCGACAGTTGG -> TCAGGTTTCGACAGTTGGT
AAAGTGTTCACTGGCTTCT -> AAGTGTTCACTGGCTTCTC
ACGGAAAATGTAGAAATAG -> CGGAAAATGTAGAAATAGG
CCAGGGCTTATTATATGTG -> CAGGGCTTATTATATGTGC
ACTGTCAATGCTGCATCTG -> CTGTCAATGCTGCATCTGT
TATTACCTGCGTTCCCTGA -> ATTACCTGCGTTCCCTGAA
TTTATTTGCTAGCCGGTAG -> TTATTTGCTAGCCGGTAGC
GGGGGCCGTTATATTTATT -> GGGGCCGTTATATTTATTT
TAAGCCACTAAGCGTTAAG -> AAGCCACTAAGCGTTAAGA
ACGGAGTGAATTTACGGGC -> CGGAGTGAATTTACGGGCG
GCAGGTTAGTCACGGAGTG -> CAGGTTAGTCACGGAGTGA
AGATGGCGTCTCAGTGTCT -> GATGGCGTCTCAGTGTCTA
TGTGCCTGTTTCCCTTGCC -> GTGCCTGTTTCCCTTGCCT
TGTAGGACCTGGGACTCCA -> GTAGGACCTGGGACTCCAA
TGTTCACTGGCTTCTCAAC -> GTTCACTGGCTTCTCAACG
CCAAACCGTCCTCATAACC -> CAAACCGTCCTCATAACCT
CTAGTGTGCCTGTTTCCCT -> TAGTGTGCCTGTTTCCCTT
GTTATATTTATTTGGTCCG -> TTATATTTATTTGGTCCGT
ATACCGTGATCTGGAGAAC -> TACCGTGATCTGGAGAACG
CTAGCTCTGTGACCCCCCC -> TAGCTCTGTGACCCCCCCC
CTCAACGCCTCTGCAAAAC -> TCAACGCCTCTGCAAAACC
TATTTATTTGCTAGCCGGT -> ATTTATTTGCTAGCCGGTA
TACCTCTATATCTTTGTGT -> ACCTCTATATCTTTGTGTT
AAAGTGAAAAAGATTGCAC -> AAGTGAAAAAGATTGCACA
AAACAAAGCGGCCGCACTG -> AACAAAGCGGCCGCACTGT
AATCCTGGTCTTGACTATT -> ATCCTGGTCTTGACTATTT
TACTTGATGTGCAGTAAGC -> ACTTGATGTGCAGTAAGCC
CTAGTACACACGTATGTTT -> TAGTACACACGTATGTTTT
ATATGTGCGGACAATTCTT -> TATGTGCGGACAATTCTTC
CATCTCCCCCAGGGCTTAT -> ATCTCCCCCAGGGCTTATT
ATTACCTGCGTTCCCTGAA -> TTACCTGCGTTCCCTGAAC
ATCCGTGCAGGAAACAAAG -> TCCGTGCAGGAAACAAAGC
TACGTCAAGTGTACGTTCG -> ACGTCAAGTGTACGTTCGG
CTGGTACTGATTCCTTTGC -> TGGTACTGATTCCTTTGCT
GAGGGTACTTGATGTGCAG -> AGGGTACTTGATGTGCAGT
TTGAGAACCGGTTTGCAGT -> TGAGAACCGGTTTGCAGTT
CGTGATCTGGAGAACGGCG -> GTGATCTGGAGAACGGCGT
AAGGTACTCCGCTCGCATA -> AGGTACTCCGCTCGCATAA
CAAAGATAGACATCTCCGT -> AAAGATAGACATCTCCGTG
AAAAGATTGCACAAGTAGT -> AAAGATTGCACAAGTAGTG
AAGTGTACGTTCGGGGATT -> AGTGTACGTTCGGGGATTT
TTTGCCCCTCGATTCCCTA -> TTGCCCCTCGATTCCCTAG
AAAGCGGCCGCACTGTCAA -> AAGCGGCCGCACTGTCAAT
GCGTTGCTAAAACTCACCT -> CGTTGCTAAAACTCACCTG
GCCTTGATTCATGCTGCCC -> CCTTGATTCATGCTGCCCT
CTCTGCAAAACCCTCTTGC -> TCTGCAAAACCCTCTTGCC
ATCGCAGGTTAGTCACGGA -> TCGCAGGTTAGTCACGGAG
GTTTGCAGTTCAAAGATAG -> TTTGCAGTTCAAAGATAGA
CCTAATTTCCTTTGTTACA -> CTAATTTCCTTTGTTACAG
CCCGTGTATTTGAGGATGC -> CCGTGTATTTGAGGATGCC
GAATGCTCTGGGGATTGGA -> AATGCTCTGGGGATTGGAC
ATGCCTTGATTCATGCTGC -> TGCCTTGATTCATGCTGCC
CGGCGTCAGTACGTATGTC -> GGCGTCAGTACGTATGTCC
ACTGGAGGGTACTTGATGT -> CTGGAGGGTACTTGATGTG
AGGAGGGGACTGGAGGGTA -> GGAGGGGACTGGAGGGTAC
ACAAGGTACTCCGCTCGCA -> CAAGGTACTCCGCTCGCAT
AAGTGTTCACTGGCTTCTC -> AGTGTTCACTGGCTTCTCA
ACCTGAACATCTCCCCCAG -> CCTGAACATCTCCCCCAGG
GTCGTTGCGTACCTCTATA -> TCGTTGCGTACCTCTATAT
GCTAGCCGGTAGCCACTCC -> CTAGCCGGTAGCCACTCCC
CGTGCAGGAAACAAAGCGG -> GTGCAGGAAACAAAGCGGC
GACACTACCCTAGCTCTGT -> ACACTACCCTAGCTCTGTG
GCTCTGTGACCCCCCCCAT -> CTCTGTGACCCCCCCCATA
CAGCGAATCCGTGCAGGAA -> AGCGAATCCGTGCAGGAAA
CGGAGCAGGGTGGCCCTCA -> GGAGCAGGGTGGCCCTCAG
GTCCGTTCATACGGTTGCT -> TCCGTTCATACGGTTGCTT
TCAGCTAGTGTGCCTGTTT -> CAGCTAGTGTGCCTGTTTC
CCTTGTAGGACCTCAGAGT -> CTTGTAGGACCTCAGAGTA
ATTCGGGTGAACGGACATG -> TTCGGGTGAACGGACATGG
TAATACGCGGCAGGTTGAT -> AATACGCGGCAGGTTGATG
CCCCACTGGCTCCAACGAA -> CCCACTGGCTCCAACGAAG
CGGTTTTCCTAATTTCCTT -> GGTTTTCCTAATTTCCTTT
AGGGTGTCATCTGCGTACA -> GGGTGTCATCTGCGTACAG
TGCGTTGCTAAAACTCACC -> GCGTTGCTAAAACTCACCT
TTCACACGGTGCGCCTGCG -> TCACACGGTGCGCCTGCGC
TTGTAGGACCTTAAGTGCT -> TGTAGGACCTTAAGTGCTA
GCGTTCAACATCCGTCTCA -> CGTTCAACATCCGTCTCAT
CGTAAATCCTGGTCTTGAC -> GTAAATCCTGGTCTTGACT
CACCCCTTAAGAGCCAAGG -> ACCCCTTAAGAGCCAAGGA
AGAAATAGGAGGAGGGGAC -> GAAATAGGAGGAGGGGACT
TTATCGCGCAGCCGCTCTA -> TATCGCGCAGCCGCTCTAC
GAGGGTGTCATCTGCGTAC -> AGGGTGTCATCTGCGTACA
TTAGTATCTTAGGGCGTTC -> TAGTATCTTAGGGCGTTCA
TGCGCCTGCGCAAGATGGA -> GCGCCTGCGCAAGATGGAA
CGCAGTGCGTTGCTAAAAC -> GCAGTGCGTTGCTAAAACT
GGGCAAGAGGCAGATTCGG -> GGCAAGAGGCAGATTCGGG
CTCCTAGACGCTGGCGCCG -> TCCTAGACGCTGGCGCCGC
CGATCCCGGCTAGATCAAG -> GATCCCGGCTAGATCAAGA
GCTACTGTCCAATGCGGGA -> CTACTGTCCAATGCGGGAA
TTGCCCCTCGATTCCCTAG -> TGCCCCTCGATTCCCTAGA
TAGATGGCGTCTCAGTGTC -> AGATGGCGTCTCAGTGTCT
TTGTGTTGCCCCGTGCGGG -> TGTGTTGCCCCGTGCGGGT
TTCCAAACCGTCCTCATAA -> TCCAAACCGTCCTCATAAC
TGTGAGGAAGCCATACCGT -> GTGAGGAAGCCATACCGTG
GAGCATTCTAAAAGTGCGA -> AGCATTCTAAAAGTGCGAA
GAAGCATGAAGGCCTGACT -> AAGCATGAAGGCCTGACTT
CGCTACTGTCCAATGCGGG -> GCTACTGTCCAATGCGGGA
TGAGGATGCCCCACTGGCT -> GAGGATGCCCCACTGGCTC
TCAGCATACCCTGGAGAGG -> CAGCATACCCTGGAGAGGC
ACCGTGATCTGGAGAACGG -> CCGTGATCTGGAGAACGGC
GGTTGCTTTTGGGGGGCCG -> GTTGCTTTTGGGGGGCCGT
AGTATTCATTCTGGTGGGT -> GTATTCATTCTGGTGGGTT
CAGGTTAGTCACGGAGTGA -> AGGTTAGTCACGGAGTGAA
TCCAACGAAGGCGCGGCGA -> CCAACGAAGGCGCGGCGAA
TGCGGACAATTCTTCCCTT -> GCGGACAATTCTTCCCTTG
ACTTGAGAACTAGTTCAAC -> CTTGAGAACTAGTTCAACT
GTATTACCTGCGTTCCCTG -> TATTACCTGCGTTCCCTGA
GCACCAACACACTGGAGGT -> CACCAACACACTGGAGGTT
TGCCCCGTGCGGGTGTCAG -> GCCCCGTGCGGGTGTCAGG
CACACGGTGCGCCTGCGCA -> ACACGGTGCGCCTGCGCAA
GGCTTATTATATGTGCGGA -> GCTTATTATATGTGCGGAC
CTTGTAGGACCTGTAGCAC -> TTGTAGGACCTGTAGCACC
ATCTCCGTGAAACGCCCTA -> TCTCCGTGAAACGCCCTAG
ACTTGACTGTCACACAGAT -> CTTGACTGTCACACAGATG
GGGCGATACCCGGAGCAGG -> GGCGATACCCGGAGCAGGG
GTGGGTTGAGGGTCCACGC -> TGGGTTGAGGGTCCACGCC
AATAGGAGGAGGGGACTGG -> ATAGGAGGAGGGGACTGGA
GCATAACGTAGCTGGACTC -> CATAACGTAGCTGGACTCC
TTGAATTTTGCGACCCACT -> TGAATTTTGCGACCCACTC
TCCCTTGCCTAGATGTACC -> CCCTTGCCTAGATGTACCA
AGCATACCCTGGAGAGGCC -> GCATACCCTGGAGAGGCCC
CCTAGACGCTGGCGCCGCA -> CTAGACGCTGGCGCCGCAG
AAATCCTGGTCTTGACTAT -> AATCCTGGTCTTGACTATT
CACGCCCAAAAGCATAACG -> ACGCCCAAAAGCATAACGT
GATGGCCATCGCTCGATAG -> ATGGCCATCGCTCGATAGT
AGGTACTCCGCTCGCATAA -> GGTACTCCGCTCGCATAAT
AGGTATGCGCTGAGGGGCA -> GGTATGCGCTGAGGGGCAC
GGCTTGCTCCCGACCATTT -> GCTTGCTCCCGACCATTTT
CGTTATATTTATTTGGTCC -> GTTATATTTATTTGGTCCG
GGGTCCACGCCCAAAAGCA -> GGTCCACGCCCAAAAGCAT
AGGCGCGGCGAACTACTTG -> GGCGCGGCGAACTACTTGT
TAATTGAGACATCAACTCA -> AATTGAGACATCAACTCAC
AAGGAATACGATGGGTTAG -> AGGAATACGATGGGTTAGT
ATGTACCAAGGCCGTTATA -> TGTACCAAGGCCGTTATAT
ACAAAAACCCGTGTATTTG -> CAAAAACCCGTGTATTTGA
GTTCAACTCACTGGGTGTC -> TTCAACTCACTGGGTGTCC
AAGCCAGTGACCTATGATG -> AGCCAGTGACCTATGATGA
TCAAGTGTACGTTCGGGGA -> CAAGTGTACGTTCGGGGAT
GAGCAGGGTGGCCCTCAGC -> AGCAGGGTGGCCCTCAGCG
CCTTGCCTGGAGTATGGGC -> CTTGCCTGGAGTATGGGCG
TCACTGGGTGTCCCAACTA -> CACTGGGTGTCCCAACTAT
GGCGTTCAACATCCGTCTC -> GCGTTCAACATCCGTCTCA
AAGGCCTTTACAATTGGAT -> AGGCCTTTACAATTGGATC
CGAATGCTCTGGGGATTGG -> GAATGCTCTGGGGATTGGA
AGAGGGTGTCATCTGCGTA -> GAGGGTGTCATCTGCGTAC
CAGCGCTAGACCAGATGGC -> AGCGCTAGACCAGATGGCC
TTGCCTAGATGTACCAAGG -> TGCCTAGATGTACCAAGGC
AAGGCCGTTATATTTATTT -> AGGCCGTTATATTTATTTG
GTTTTGCGATCCCGGCTAG -> TTTTGCGATCCCGGCTAGA
TGCCCCGCACCCTTCCAAA -> GCCCCGCACCCTTCCAAAC
TGTCAGCTAGTGTGCCTGT -> GTCAGCTAGTGTGCCTGTT
AACTAGTTCAACTCACTGG -> ACTAGTTCAACTCACTGGG
TCCGCTCGCATAATGAACT -> CCGCTCGCATAATGAACTT
CAGATTCGGGTGAACGGAC -> AGATTCGGGTGAACGGACA
GATGGAAGCATGAAGGCCT -> ATGGAAGCATGAAGGCCTG
TTGTAGGACCTCAGAGTAT -> TGTAGGACCTCAGAGTATT
CACACAGATGGAAGCATGA -> ACACAGATGGAAGCATGAA
CACTCCCTTGTAGGACCTG -> ACTCCCTTGTAGGACCTGT, ACTCCCTTGTAGGACCTGG
TCTTGAAACGGGCAAGAGG -> CTTGAAACGGGCAAGAGGC
TAAGCCAGTGACCTATGAT -> AAGCCAGTGACCTATGATG
ACCAAGATCACGGAAAATG -> CCAAGATCACGGAAAATGT
TAAGACTTAGAATACCAAG -> AAGACTTAGAATACCAAGA
CAACCCATCAGCATACCCT -> AACCCATCAGCATACCCTG
AGGAATACGATGGGTTAGT -> GGAATACGATGGGTTAGTA
GTGTTGCCCCGTGCGGGTG -> TGTTGCCCCGTGCGGGTGT
CGTATGTCCAACCCATCAG -> GTATGTCCAACCCATCAGC
ATTGCACAAGTAGTGTGGA -> TTGCACAAGTAGTGTGGAG
TTCGACAGTTGGTAGATGT -> TCGACAGTTGGTAGATGTT
CAATGCGGGAATCCGAACA -> AATGCGGGAATCCGAACAC
AGCCAGTGACCTATGATGA -> GCCAGTGACCTATGATGAG
CGTCATAGCCAGGCAACGG -> GTCATAGCCAGGCAACGGT
GAGAGGCCCACATGGCAAA -> AGAGGCCCACATGGCAAAG
ATATCTTTGTGTTGCCCCG -> TATCTTTGTGTTGCCCCGT
TTACAATTGGATCACAAAA -> TACAATTGGATCACAAAAA
CGCCCCTCCTAGACGCTGG -> GCCCCTCCTAGACGCTGGC
ACACACGTATGTTTTGCGA -> CACACGTATGTTTTGCGAT
AACCCTCTTGCCTAGTACA -> ACCCTCTTGCCTAGTACAC
AAGTGGTGGTCGAATGCTC -> AGTGGTGGTCGAATGCTCT
TCGCGCAGCCGCTCTACTT -> CGCGCAGCCGCTCTACTTG
TGGCTTCTCAACGCCTCTG -> GGCTTCTCAACGCCTCTGC
TATTTATTTGTGCAGAGAA -> ATTTATTTGTGCAGAGAAT
ATTCCACTCCCTTGTAGGA -> TTCCACTCCCTTGTAGGAC
CACCAACACACTGGAGGTT -> ACCAACACACTGGAGGTTC
TCCATTCTAGCGGAAGGCG -> CCATTCTAGCGGAAGGCGT
TGGGTTAGTATCTTAGGGC -> GGGTTAGTATCTTAGGGCG
CCTTGTAGGACCTGTAGCA -> CTTGTAGGACCTGTAGCAC
GTTATATTTATTTGTGCAG -> TTATATTTATTTGTGCAGA
TACTGTCCAATGCGGGAAT -> ACTGTCCAATGCGGGAATC
AGAACGGCGTCAGTACGTA -> GAACGGCGTCAGTACGTAT
CACCCTTCCAAACCGTCCT -> ACCCTTCCAAACCGTCCTC
AATGCTCTGGGGATTGGAC -> ATGCTCTGGGGATTGGACG
ATTGGACCCCCAGAGGGTG -> TTGGACCCCCAGAGGGTGT
TTATTTGTGCAGAGAATTC -> TATTTGTGCAGAGAATTCC
AAGGATTTTAGCGCGTCGA -> AGGATTTTAGCGCGTCGAT
CCATCCGCTCGGTAAGTGG -> CATCCGCTCGGTAAGTGGT
TGAAACGCCCTAGTAATTG -> GAAACGCCCTAGTAATTGA
GCGAACTACTTGTGAGGAA -> CGAACTACTTGTGAGGAAG
GGTAGCCACTCCCTTGTAG -> GTAGCCACTCCCTTGTAGG
GCCGTTATATTTATTTGAA -> CCGTTATATTTATTTGAAT
TACCCTAGCTCTGTGACCC -> ACCCTAGCTCTGTGACCCC
CTAAGACTTAGAATACCAA -> TAAGACTTAGAATACCAAG
GAACACCCCTTAAGAGCCA -> AACACCCCTTAAGAGCCAA
CGTCAAGTGTACGTTCGGG -> GTCAAGTGTACGTTCGGGG
AGTACGTATGTCCAACCCA -> GTACGTATGTCCAACCCAT
AGAACTAGTTCAACTCACT -> GAACTAGTTCAACTCACTG
TTGAATCTCCGAAGTGAGC -> TGAATCTCCGAAGTGAGCC
GCGACCCACTCCCTTGTAG -> CGACCCACTCCCTTGTAGG
AGATTCGGGTGAACGGACA -> GATTCGGGTGAACGGACAT
ACCTTAAGTGCTAATCGCA -> CCTTAAGTGCTAATCGCAG
AATTTCCTTTGTTACAGCA -> ATTTCCTTTGTTACAGCAA
GACCATTTTGAGAACCGGT -> ACCATTTTGAGAACCGGTT
CAGAGTATTACCTGCGTTC -> AGAGTATTACCTGCGTTCC
ATTCCCTAGATGGCGTCTC -> TTCCCTAGATGGCGTCTCA
CCCATCAGCATACCCTGGA -> CCATCAGCATACCCTGGAG
TACCTGCGTTCCCTGAACC -> ACCTGCGTTCCCTGAACCG
CAACATCCGTCTCATGATA -> AACATCCGTCTCATGATAA
GTCGCTACTGTCCAATGCG -> TCGCTACTGTCCAATGCGG
CTAAGCGTTAAGAACAATC -> TAAGCGTTAAGAACAATCG
ACCATTTTGAGAACCGGTT -> CCATTTTGAGAACCGGTTT
AGGTTTCGACAGTTGGTAG -> GGTTTCGACAGTTGGTAGA
ACTCCCTTGTAGGACCTGT -> CTCCCTTGTAGGACCTGTA
TGGCACTGGCCGGGGCGGC -> GGCACTGGCCGGGGCGGCC
TTTCCTAATTTCCTTTGTT -> TTCCTAATTTCCTTTGTTA
CAAGATGGAAAAAGTGTTC -> AAGATGGAAAAAGTGTTCA
CGGTACGTCAAGTGTACGT -> GGTACGTCAAGTGTACGTT
ACGGTTTTCCTAATTTCCT -> CGGTTTTCCTAATTTCCTT
TGACCGACAAAGTTCCGGT -> GACCGACAAAGTTCCGGTG
ACGGACAAAAGCGGATTGA -> CGGACAAAAGCGGATTGAC
CCCGGCTAGATCAAGAAGG -> CCGGCTAGATCAAGAAGGC
CGTACTCCCCACTCCCTTG -> GTACTCCCCACTCCCTTGT
CATACCCTGGAGAGGCCCA -> ATACCCTGGAGAGGCCCAC
CAATTGGATCACAAAAACC -> AATTGGATCACAAAAACCC
TCATAGCCAGGCAACGGTT -> CATAGCCAGGCAACGGTTT
GTTATATTTATTTGCTAGC -> TTATATTTATTTGCTAGCC
CGCACCCTTCCAAACCGTC -> GCACCCTTCCAAACCGTCC
ACTCCGCTCGCATAATGAA -> CTCCGCTCGCATAATGAAC
TGGAGTATGGGCGCGACAA -> GGAGTATGGGCGCGACAAA
GAGGAGGGGACTGGAGGGT -> AGGAGGGGACTGGAGGGTA
AGCGCTAGACCAGATGGCC -> GCGCTAGACCAGATGGCCA
CGTTATATTTATTTGAATT -> GTTATATTTATTTGAATTT
GCGGAAGGCGTGCGTCATA -> CGGAAGGCGTGCGTCATAG
CCACATGGCAAAGCAGGCG -> CACATGGCAAAGCAGGCGA
TCTGCAAAACCCTCTTGCC -> CTGCAAAACCCTCTTGCCT
GATCAAGAAGGCCTTTACA -> ATCAAGAAGGCCTTTACAA
CTAGCGGAAGGCGTGCGTC -> TAGCGGAAGGCGTGCGTCA
TAGTATTCATTCTGGTGGG -> AGTATTCATTCTGGTGGGT
AATGGCCGTTATATTTATT -> ATGGCCGTTATATTTATTT
CCCTAGTAATTGAGACATC -> CCTAGTAATTGAGACATCA
TATCTTAGGGCGTTCAACA -> ATCTTAGGGCGTTCAACAT
GGCTCCAACGAAGGCGCGG -> GCTCCAACGAAGGCGCGGC
TTGCTAAAACTCACCTGAA -> TGCTAAAACTCACCTGAAC
TTATTATATGTGCGGACAA -> TATTATATGTGCGGACAAT
AACGGCGTCAGTACGTATG -> ACGGCGTCAGTACGTATGT
TCGCATAATGAACTTAGTA -> CGCATAATGAACTTAGTAG
CTTGACTGTCACACAGATG -> TTGACTGTCACACAGATGG
GCCGGGGCTTGCTCCCGAC -> CCGGGGCTTGCTCCCGACC
GGGTGTCCCAACTATTGAA -> GGTGTCCCAACTATTGAAT
AGGGTGGCCCTCAGCGCTA -> GGGTGGCCCTCAGCGCTAG
ACCGGTTTGCAGTTCAAAG -> CCGGTTTGCAGTTCAAAGA
GTACAAATGCCCCGCACCC -> TACAAATGCCCCGCACCCT
CCCTTCCAAACCGTCCTCA -> CCTTCCAAACCGTCCTCAT
CTAGTTCAACTCACTGGGT -> TAGTTCAACTCACTGGGTG
CACGTATGTTTTGCGATCC -> ACGTATGTTTTGCGATCCC
ACAAATGCCCCGCACCCTT -> CAAATGCCCCGCACCCTTC
CTGGTCTTGACTATTTACT -> TGGTCTTGACTATTTACTT
ATATTTATTTGCTAGCCGG -> TATTTATTTGCTAGCCGGT
TAGAAATAGGAGGAGGGGA -> AGAAATAGGAGGAGGGGAC
TAATCGCAGGTTAGTCACG -> AATCGCAGGTTAGTCACGG
TCATGCTGCCCTAAGGGGA -> CATGCTGCCCTAAGGGGAC
ACTGGCTTCTCAACGCCTC -> CTGGCTTCTCAACGCCTCT
AACACACTGGAGGTTCCAT -> ACACACTGGAGGTTCCATT
TTTTAGCGCGTCGATAGGG -> TTTAGCGCGTCGATAGGGG
TGGAGGTTCCATTCTAGCG -> GGAGGTTCCATTCTAGCGG
ATTCTAGCGGAAGGCGTGC -> TTCTAGCGGAAGGCGTGCG
CATAATGAACTTAGTAGGT -> ATAATGAACTTAGTAGGTC
GGAAAATGTAGAAATAGGA -> GAAAATGTAGAAATAGGAG
GGACGAATTCGTTTTATCG -> GACGAATTCGTTTTATCGC
ATGTTTTGCGATCCCGGCT -> TGTTTTGCGATCCCGGCTA
TGACCATCCGCTCGGTAAG -> GACCATCCGCTCGGTAAGT
TATTCATTCTGGTGGGTTG -> ATTCATTCTGGTGGGTTGA
CTAGTAATTGAGACATCAA -> TAGTAATTGAGACATCAAC
ATTTGAATTTTGCGACCCA -> TTTGAATTTTGCGACCCAC
ATTTACTTATAATACGCGG -> TTTACTTATAATACGCGGC
ATTGAGACATCAACTCACG -> TTGAGACATCAACTCACGG
AGCACCGTTCAAAACGGAC -> GCACCGTTCAAAACGGACA
ACGGAGCTGACGCCCCTCC -> CGGAGCTGACGCCCCTCCT
AACATCCGTCTCATGATAA -> ACATCCGTCTCATGATAAG
TTCCATTCTAGCGGAAGGC -> TCCATTCTAGCGGAAGGCG
CCTATGCCTTGCCTGGAGT -> CTATGCCTTGCCTGGAGTA
GTGCGGGTGTCAGGTTTCG -> TGCGGGTGTCAGGTTTCGA
GTATGCGCTGAGGGGCACC -> TATGCGCTGAGGGGCACCA
GATAGGGGTGGTCGACACT -> ATAGGGGTGGTCGACACTA
CCTTGATTCATGCTGCCCT -> CTTGATTCATGCTGCCCTA
CTGGACTCCAGTACAAATG -> TGGACTCCAGTACAAATGC
AAACGGACAAAAGCGGATT -> AACGGACAAAAGCGGATTG
CCTTGTAGGACCTTAAGTG -> CTTGTAGGACCTTAAGTGC
GTGGTCGACACTACCCTAG -> TGGTCGACACTACCCTAGC
CGATAGTATTCATTCTGGT -> GATAGTATTCATTCTGGTG
AGGAAGCCATACCGTGATC -> GGAAGCCATACCGTGATCT
CTAAGGGGACGAATTCGTT -> TAAGGGGACGAATTCGTTT
TGGCCGGGGCGGCCGTTAT -> GGCCGGGGCGGCCGTTATA
CTGATTGCTAAGGAATACG -> TGATTGCTAAGGAATACGA
CTTGTAGGACCTGGGACTC -> TTGTAGGACCTGGGACTCC
CTCCCCACTCCCTTGTAGG -> TCCCCACTCCCTTGTAGGA
TGTCAATGCTGCATCTGTC -> GTCAATGCTGCATCTGTCA
CGAACACCCCTTAAGAGCC -> GAACACCCCTTAAGAGCCA
AGTTTCCCACTAAGACTTA -> GTTTCCCACTAAGACTTAG
GACGAATTCGTTTTATCGC -> ACGAATTCGTTTTATCGCG
ATGCGTCGTTGCGTACCTC -> TGCGTCGTTGCGTACCTCT
CCGTGAAACGCCCTAGTAA -> CGTGAAACGCCCTAGTAAT
ATCAAGAAGGCCTTTACAA -> TCAAGAAGGCCTTTACAAT
GAACTAGTTCAACTCACTG -> AACTAGTTCAACTCACTGG
GCTAGTGTGCCTGTTTCCC -> CTAGTGTGCCTGTTTCCCT
GTAGGACCTGTAGCACCGT -> TAGGACCTGTAGCACCGTT
GCTGATTGCTAAGGAATAC -> CTGATTGCTAAGGAATACG
GCGAAAGTGAAAAAGATTG -> CGAAAGTGAAAAAGATTGC
CCAAATGGCCGTTATATTT -> CAAATGGCCGTTATATTTA
GCCTGACTTTCGTGGCACT -> CCTGACTTTCGTGGCACTG
GGAGGGTACTTGATGTGCA -> GAGGGTACTTGATGTGCAG
GACCCACTCCCTTGTAGGA -> ACCCACTCCCTTGTAGGAC
TGTCCAATGCGGGAATCCG -> GTCCAATGCGGGAATCCGA
CCGTTATATTTATTTGAAT -> CGTTATATTTATTTGAATT
TGCAGGAAACAAAGCGGCC -> GCAGGAAACAAAGCGGCCG
CCAACTTGAGAACTAGTTC -> CAACTTGAGAACTAGTTCA
ATAGGAGGAGGGGACTGGA -> TAGGAGGAGGGGACTGGAG
CGTTGCTAAAACTCACCTG -> GTTGCTAAAACTCACCTGA
GTTCAAAGATAGACATCTC -> TTCAAAGATAGACATCTCC
AAGGCCTGACTTTCGTGGC -> AGGCCTGACTTTCGTGGCA
AAAGCCGGGGCTTGCTCCC -> AAGCCGGGGCTTGCTCCCG
ACGCCCCTCCTAGACGCTG -> CGCCCCTCCTAGACGCTGG
ACATCTCCGTGAAACGCCC -> CATCTCCGTGAAACGCCCT
CAGTACAAATGCCCCGCAC -> AGTACAAATGCCCCGCACC
TTGACTATTTACTTATAAT -> TGACTATTTACTTATAATA
TCTGGAGAACGGCGTCAGT -> CTGGAGAACGGCGTCAGTA
CGGGGCTTGCTCCCGACCA -> GGGGCTTGCTCCCGACCAT
CGCTCTACTTGACTGTCAC -> GCTCTACTTGACTGTCACA
ACGCCTCTGCAAAACCCTC -> CGCCTCTGCAAAACCCTCT
GCAATCATAAGCCAGTGAC -> CAATCATAAGCCAGTGACC
CAAAACGGACAAAAGCGGA -> AAAACGGACAAAAGCGGAT
CCGTGCAGGAAACAAAGCG -> CGTGCAGGAAACAAAGCGG
TAGTCACGGAGTGAATTTA -> AGTCACGGAGTGAATTTAC
TCATGATAAGCGGTACGTC -> CATGATAAGCGGTACGTCA
GCTAAAACTCACCTGAACA -> CTAAAACTCACCTGAACAT
GCGATTGGACCCCCAGAGG -> CGATTGGACCCCCAGAGGG
ATTCCTTTGCTGATTGCTA -> TTCCTTTGCTGATTGCTAA
TCCCAACTATTGAATCTCC -> CCCAACTATTGAATCTCCG
GCGGGAATCCGAACACCCC -> CGGGAATCCGAACACCCCT
AATACGATGGGTTAGTATC -> ATACGATGGGTTAGTATCT
GGTCGAATGCTCTGGGGAT -> GTCGAATGCTCTGGGGATT
ATTTACGGGCGAAGAAGTA -> TTTACGGGCGAAGAAGTAT
ATGCGGGAATCCGAACACC -> TGCGGGAATCCGAACACCC
CTCAGTGTCTATTCGATCT -> TCAGTGTCTATTCGATCTT
GATCACAAAAACCCGTGTA -> ATCACAAAAACCCGTGTAT
TGAATGCCTTGATTCATGC -> GAATGCCTTGATTCATGCT
GATGAGGCGCATAGCACCG -> ATGAGGCGCATAGCACCGC
ACACAGATGGAAGCATGAA -> CACAGATGGAAGCATGAAG
GAACTACTTGTGAGGAAGC -> AACTACTTGTGAGGAAGCC
AATGCTGCATCTGTCAGCT -> ATGCTGCATCTGTCAGCTA
CCGTTATATTTATTTGTGC -> CGTTATATTTATTTGTGCA
CTGTCACACAGATGGAAGC -> TGTCACACAGATGGAAGCA
GGGTTGAGGGTCCACGCCC -> GGTTGAGGGTCCACGCCCA
ATATTTATTTGAATTTTGC -> TATTTATTTGAATTTTGCG
GATTCCTTTGCTGATTGCT -> ATTCCTTTGCTGATTGCTA
CTGGGACTCCAACTTGAGA -> TGGGACTCCAACTTGAGAA
ATAACCTATGCCTTGCCTG -> TAACCTATGCCTTGCCTGG
GAAGCCATACCGTGATCTG -> AAGCCATACCGTGATCTGG
AGGACCTGTAGCACCGTTC -> GGACCTGTAGCACCGTTCA
ACTAGTTCAACTCACTGGG -> CTAGTTCAACTCACTGGGT
GTATGTCCAACCCATCAGC -> TATGTCCAACCCATCAGCA
CCATCCCGTTTTCGAGGTC -> CATCCCGTTTTCGAGGTCA
GGGTGAACGGACATGGTGG -> GGTGAACGGACATGGTGGG
TGGGTGTCCCAACTATTGA -> GGGTGTCCCAACTATTGAA
TCATACGGTTGCTTTTGGG -> CATACGGTTGCTTTTGGGG
GGCAAGAGGCAGATTCGGG -> GCAAGAGGCAGATTCGGGT
ATTGGACGTAAATCCTGGT -> TTGGACGTAAATCCTGGTC
CTTTCGTGGCACTGGCCGG -> TTTCGTGGCACTGGCCGGG
GAGACATCAACTCACGGAG -> AGACATCAACTCACGGAGC
AGCCGGTAGCCACTCCCTT -> GCCGGTAGCCACTCCCTTG
GCAGTGCGTTGCTAAAACT -> CAGTGCGTTGCTAAAACTC
CTGCGCAAGATGGAAAAAG -> TGCGCAAGATGGAAAAAGT
GCGTCTCAGTGTCTATTCG -> CGTCTCAGTGTCTATTCGA
CTGTCAGCTAGTGTGCCTG -> TGTCAGCTAGTGTGCCTGT
AGCGCGTCGATAGGGGTGG -> GCGCGTCGATAGGGGTGGT
CAAAGTTCCGGTGTCCATC -> AAAGTTCCGGTGTCCATCC
GTAGAAATAGGAGGAGGGG -> TAGAAATAGGAGGAGGGGA
TGTCCCAACTATTGAATCT -> GTCCCAACTATTGAATCTC
TCACGGAGTGAATTTACGG -> CACGGAGTGAATTTACGGG
CAGAGGGTGTCATCTGCGT -> AGAGGGTGTCATCTGCGTA
CTGCATCTGTCAGCTAGTG -> TGCATCTGTCAGCTAGTGT
CAAGTGTACGTTCGGGGAT -> AAGTGTACGTTCGGGGATT
ATGATGAGGCGCATAGCAC -> TGATGAGGCGCATAGCACC
CTGACTTTCGTGGCACTGG -> TGACTTTCGTGGCACTGGC
TCTGGTACTGATTCCTTTG -> CTGGTACTGATTCCTTTGC
AGCCATACCGTGATCTGGA -> GCCATACCGTGATCTGGAG
ATCGCGCAGCCGCTCTACT -> TCGCGCAGCCGCTCTACTT
AGCCACTCCCTTGTAGGAC -> GCCACTCCCTTGTAGGACC
ACTGTCCAATGCGGGAATC -> CTGTCCAATGCGGGAATCC
TGGTAGATGTTAAGGTATG -> GGTAGATGTTAAGGTATGC
GTGAATGCCTTGATTCATG -> TGAATGCCTTGATTCATGC
GCGTCAGTACGTATGTCCA -> CGTCAGTACGTATGTCCAA
TTGAGGATGCCCCACTGGC -> TGAGGATGCCCCACTGGCT
CCTCTATATCTTTGTGTTG -> CTCTATATCTTTGTGTTGC
ATATTTATTTGTGCAGAGA -> TATTTATTTGTGCAGAGAA
GCACCGCAAAGTTGGAGAG -> CACCGCAAAGTTGGAGAGT
ATCAGCATACCCTGGAGAG -> TCAGCATACCCTGGAGAGG
AGAATTCCACTCCCTTGTA -> GAATTCCACTCCCTTGTAG
ATGCTGCCCTAAGGGGACG -> TGCTGCCCTAAGGGGACGA
TTCTAGCGGAAGGCGTGCG -> TCTAGCGGAAGGCGTGCGT
ACTATTGAATCTCCGAAGT -> CTATTGAATCTCCGAAGTG
GATTCCCTAGATGGCGTCT -> ATTCCCTAGATGGCGTCTC
GGAGTGAATTTACGGGCGA -> GAGTGAATTTACGGGCGAA
TGTAGAAATAGGAGGAGGG -> GTAGAAATAGGAGGAGGGG
TTTGTGTTGCCCCGTGCGG -> TTGTGTTGCCCCGTGCGGG
AGCATGAAGGCCTGACTTT -> GCATGAAGGCCTGACTTTC
CAGCAATCATAAGCCAGTG -> AGCAATCATAAGCCAGTGA
TCTGTGACCCCCCCCATAT -> CTGTGACCCCCCCCATATC
CGGATTGACCATCCGCTCG -> GGATTGACCATCCGCTCGG
GGACCTCAGAGTATTACCT -> GACCTCAGAGTATTACCTG
TACAAATGCCCCGCACCCT -> ACAAATGCCCCGCACCCTT
TTCGTTTTATCGCGCAGCC -> TCGTTTTATCGCGCAGCCG
GCCGTTATATTTATTTGCT -> CCGTTATATTTATTTGCTA
TTTTATCGCGCAGCCGCTC -> TTTATCGCGCAGCCGCTCT
CTCTTGCCTAGTACACACG -> TCTTGCCTAGTACACACGT
GTAGCACCGTTCAAAACGG -> TAGCACCGTTCAAAACGGA
TTTGCTAGCCGGTAGCCAC -> TTGCTAGCCGGTAGCCACT
TTTCGTGGCACTGGCCGGG -> TTCGTGGCACTGGCCGGGG
GAATCCGTGCAGGAAACAA -> AATCCGTGCAGGAAACAAA
TAGCCAGGCAACGGTTTTC -> AGCCAGGCAACGGTTTTCC
TCTACTTGACTGTCACACA -> CTACTTGACTGTCACACAG
ACCCCCAGAGGGTGTCATC -> CCCCCAGAGGGTGTCATCT
TATTTGTGCAGAGAATTCC -> ATTTGTGCAGAGAATTCCA
CACACGTATGTTTTGCGAT -> ACACGTATGTTTTGCGATC
TGGCCGTTATATTTATTTG -> GGCCGTTATATTTATTTGT
CTGGAGAGGCCCACATGGC -> TGGAGAGGCCCACATGGCA
TTATATTTATTTGGTCCGT -> TATATTTATTTGGTCCGTA
CGAAGTGAGCCAAATGGCC -> GAAGTGAGCCAAATGGCCG
GGCGGCCGTTATATTTATT -> GCGGCCGTTATATTTATTT
ACTCCCTTGTAGGACCTGG -> CTCCCTTGTAGGACCTGGG
GTTAGTATCTTAGGGCGTT -> TTAGTATCTTAGGGCGTTC
GTCACGTCGCTACTGTCCA -> TCACGTCGCTACTGTCCAA
CAACTTGAGAACTAGTTCA -> AACTTGAGAACTAGTTCAA
AATCATAAGCCAGTGACCT -> ATCATAAGCCAGTGACCTA
TTCATGCTGCCCTAAGGGG -> TCATGCTGCCCTAAGGGGA
AGGACCTGGGACTCCAACT -> GGACCTGGGACTCCAACTT
CGTGCGGGTGTCAGGTTTC -> GTGCGGGTGTCAGGTTTCG
ACCGACAAAGTTCCGGTGT -> CCGACAAAGTTCCGGTGTC
CAGAGAATTCCACTCCCTT -> AGAGAATTCCACTCCCTTG
GGGTTAGTATCTTAGGGCG -> GGTTAGTATCTTAGGGCGT
TCCGTTCATACGGTTGCTT -> CCGTTCATACGGTTGCTTT
TGCATCTGTCAGCTAGTGT -> GCATCTGTCAGCTAGTGTG
AGATGGAAAAAGTGTTCAC -> GATGGAAAAAGTGTTCACT
CCCGACCATTTTGAGAACC -> CCGACCATTTTGAGAACCG
TGTGGAGTTTCCCACTAAG -> GTGGAGTTTCCCACTAAGA
GCGCATAGCACCGCAAAGT -> CGCATAGCACCGCAAAGTT
TGAGAACTAGTTCAACTCA -> GAGAACTAGTTCAACTCAC
AGTGTCTATTCGATCTTGA -> GTGTCTATTCGATCTTGAA
ACCGTCCTCATAACCTATG -> CCGTCCTCATAACCTATGC
ACACCCCTTAAGAGCCAAG -> CACCCCTTAAGAGCCAAGG
TTGCTAGCCGGTAGCCACT -> TGCTAGCCGGTAGCCACTC
CTCCCTTGTAGGACCTGTA -> TCCCTTGTAGGACCTGTAG
AGTAGTGTGGAGTTTCCCA -> GTAGTGTGGAGTTTCCCAC
TTCAACTCACTGGGTGTCC -> TCAACTCACTGGGTGTCCC
AAGTTCCGGTGTCCATCCC -> AGTTCCGGTGTCCATCCCG
GTGACCCCCCCCATATCAG -> TGACCCCCCCCATATCAGC
TTTACGGGCGAAGAAGTAT -> TTACGGGCGAAGAAGTATA
GCGCAAGATGGAAAAAGTG -> CGCAAGATGGAAAAAGTGT
TCCTAATTTCCTTTGTTAC -> CCTAATTTCCTTTGTTACA
GCAGGTTGATGCGTCGTTG -> CAGGTTGATGCGTCGTTGC
AACCGTCCTCATAACCTAT -> ACCGTCCTCATAACCTATG
CTCCAACTTGAGAACTAGT -> TCCAACTTGAGAACTAGTT
CTGGGTGTCCCAACTATTG -> TGGGTGTCCCAACTATTGA
TCCAATGCGGGAATCCGAA -> CCAATGCGGGAATCCGAAC
GGATTTGCCCCTCGATTCC -> GATTTGCCCCTCGATTCCC
ATGAAGGCCTGACTTTCGT -> TGAAGGCCTGACTTTCGTG
GGACCTGGGACTCCAACTT -> GACCTGGGACTCCAACTTG
TTTATTTGAATTTTGCGAC -> TTATTTGAATTTTGCGACC
GGACCTTAAGTGCTAATCG -> GACCTTAAGTGCTAATCGC
AGCAGGCGATTGGACCCCC -> GCAGGCGATTGGACCCCCA
GGCCGTTATATTTATTTGA -> GCCGTTATATTTATTTGAA
GGGGACTGGAGGGTACTTG -> GGGACTGGAGGGTACTTGA
GGATGCCCCACTGGCTCCA -> GATGCCCCACTGGCTCCAA
GGGCTTATTATATGTGCGG -> GGCTTATTATATGTGCGGA
TGGAGGGTACTTGATGTGC -> GGAGGGTACTTGATGTGCA
ACGGTTGCTTTTGGGGGGC -> CGGTTGCTTTTGGGGGGCC
AAAGTTGGAGAGTGACCGA -> AAGTTGGAGAGTGACCGAC
CAGGCGATTGGACCCCCAG -> AGGCGATTGGACCCCCAGA
ACAAGTAGTGTGGAGTTTC -> CAAGTAGTGTGGAGTTTCC
TTACTTATAATACGCGGCA -> TACTTATAATACGCGGCAG
CCGTTCATACGGTTGCTTT -> CGTTCATACGGTTGCTTTT
AGAGGCAGATTCGGGTGAA -> GAGGCAGATTCGGGTGAAC
TAAGTGGTGGTCGAATGCT -> AAGTGGTGGTCGAATGCTC
GAAGGCGCGGCGAACTACT -> AAGGCGCGGCGAACTACTT
GTTAGTCACGGAGTGAATT -> TTAGTCACGGAGTGAATTT
ACTAAGACTTAGAATACCA -> CTAAGACTTAGAATACCAA
CGTCAGTACGTATGTCCAA -> GTCAGTACGTATGTCCAAC
ACTACTTGTGAGGAAGCCA -> CTACTTGTGAGGAAGCCAT
ATGGGTTAGTATCTTAGGG -> TGGGTTAGTATCTTAGGGC
CGTACAGGTGAATGCCTTG -> GTACAGGTGAATGCCTTGA
TACAATTGGATCACAAAAA -> ACAATTGGATCACAAAAAC
CGCATAGCACCGCAAAGTT -> GCATAGCACCGCAAAGTTG
GAACATCTCCCCCAGGGCT -> AACATCTCCCCCAGGGCTT
CCATCAGCATACCCTGGAG -> CATCAGCATACCCTGGAGA
CCCTGAACCGGCGAGCATT -> CCTGAACCGGCGAGCATTC
CCTCAGCGCTAGACCAGAT -> CTCAGCGCTAGACCAGATG
GGTATGCGCTGAGGGGCAC -> GTATGCGCTGAGGGGCACC
TGAACATCTCCCCCAGGGC -> GAACATCTCCCCCAGGGCT
TGTAGGACCTTAAGTGCTA -> GTAGGACCTTAAGTGCTAA
TGCGTACAGGTGAATGCCT -> GCGTACAGGTGAATGCCTT
TGCTGCCCTAAGGGGACGA -> GCTGCCCTAAGGGGACGAA
ACTTAGTAGGTCTAGGGCG -> CTTAGTAGGTCTAGGGCGA
ACCCCTTAAGAGCCAAGGA -> CCCCTTAAGAGCCAAGGAT
AACTCACTGGGTGTCCCAA -> ACTCACTGGGTGTCCCAAC
TAGCTCTGTGACCCCCCCC -> AGCTCTGTGACCCCCCCCA
TATGATGAGGCGCATAGCA -> ATGATGAGGCGCATAGCAC
CTTGCCTAGTACACACGTA -> TTGCCTAGTACACACGTAT
GGTACGTCAAGTGTACGTT -> GTACGTCAAGTGTACGTTC
AATCCGAACACCCCTTAAG -> ATCCGAACACCCCTTAAGA
GTGCAGAGAATTCCACTCC -> TGCAGAGAATTCCACTCCC
AAGGCGCGGCGAACTACTT -> AGGCGCGGCGAACTACTTG
AGCGGATTGACCATCCGCT -> GCGGATTGACCATCCGCTC
ACCTGCGTTCCCTGAACCG -> CCTGCGTTCCCTGAACCGG
GTCAAGTGTACGTTCGGGG -> TCAAGTGTACGTTCGGGGA
TGGCTAATGTCCGTTCATA -> GGCTAATGTCCGTTCATAC
TTACCTGCGTTCCCTGAAC -> TACCTGCGTTCCCTGAACC
CCCCTCGATTCCCTAGATG -> CCCTCGATTCCCTAGATGG
GCGGACAATTCTTCCCTTG -> CGGACAATTCTTCCCTTGG
GCCTTTACAATTGGATCAC -> CCTTTACAATTGGATCACA
CGCTCGGTAAGTGGTGGTC -> GCTCGGTAAGTGGTGGTCG
TATTTGAGGATGCCCCACT -> ATTTGAGGATGCCCCACTG
CTGTAGCACCGTTCAAAAC -> TGTAGCACCGTTCAAAACG
CATCTCCGTGAAACGCCCT -> ATCTCCGTGAAACGCCCTA
TTGGACCCCCAGAGGGTGT -> TGGACCCCCAGAGGGTGTC
GCAGGGTGGCCCTCAGCGC -> CAGGGTGGCCCTCAGCGCT
CCGGCGAGCATTCTAAAAG -> CGGCGAGCATTCTAAAAGT
CCCACTGGCTCCAACGAAG -> CCACTGGCTCCAACGAAGG
CCGGTTTGCAGTTCAAAGA -> CGGTTTGCAGTTCAAAGAT
GGACTCCAGTACAAATGCC -> GACTCCAGTACAAATGCCC
ATGCTGCATCTGTCAGCTA -> TGCTGCATCTGTCAGCTAG
GAAGGCCTTTACAATTGGA -> AAGGCCTTTACAATTGGAT
TATATTTATTTGTGCAGAG -> ATATTTATTTGTGCAGAGA
CCCTTGTAGGACCTGGGAC -> CCTTGTAGGACCTGGGACT
TTGAGGGTCCACGCCCAAA -> TGAGGGTCCACGCCCAAAA
TTCTAAAAGTGCGAAAGTG -> TCTAAAAGTGCGAAAGTGA
ACCAAGGCCGTTATATTTA -> CCAAGGCCGTTATATTTAT
GGTGTCAGGTTTCGACAGT -> GTGTCAGGTTTCGACAGTT
CTGGTGGGTTGAGGGTCCA -> TGGTGGGTTGAGGGTCCAC
CCCTTAAGAGCCAAGGATT -> CCTTAAGAGCCAAGGATTT
TGCCCCTCGATTCCCTAGA -> GCCCCTCGATTCCCTAGAT
GGATTTTAGCGCGTCGATA -> GATTTTAGCGCGTCGATAG
CAGTGACCTATGATGAGGC -> AGTGACCTATGATGAGGCG
GGTACTTGATGTGCAGTAA -> GTACTTGATGTGCAGTAAG
AGCCACTAAGCGTTAAGAA -> GCCACTAAGCGTTAAGAAC
ATGAACTTAGTAGGTCTAG -> TGAACTTAGTAGGTCTAGG
CATACGGTTGCTTTTGGGG -> ATACGGTTGCTTTTGGGGG
TGATTGCTAAGGAATACGA -> GATTGCTAAGGAATACGAT
GTTCATACGGTTGCTTTTG -> TTCATACGGTTGCTTTTGG
TGTGCGGACAATTCTTCCC -> GTGCGGACAATTCTTCCCT
ATCTGTCAGCTAGTGTGCC -> TCTGTCAGCTAGTGTGCCT
CCAAGGCCGTTATATTTAT -> CAAGGCCGTTATATTTATT
CCTTAAGAGCCAAGGATTT -> CTTAAGAGCCAAGGATTTT
ACCCACTCCCTTGTAGGAC -> CCCACTCCCTTGTAGGACC
TTAGAATACCAAGATCACG -> TAGAATACCAAGATCACGG
ACAGGTGAATGCCTTGATT -> CAGGTGAATGCCTTGATTC
ATGTAGAAATAGGAGGAGG -> TGTAGAAATAGGAGGAGGG
GTGCGTTGCTAAAACTCAC -> TGCGTTGCTAAAACTCACC
AATGAACTTAGTAGGTCTA -> ATGAACTTAGTAGGTCTAG
CTTAGGGCGTTCAACATCC -> TTAGGGCGTTCAACATCCG
CCTAGATGTACCAAGGCCG -> CTAGATGTACCAAGGCCGT
CTGAACATCTCCCCCAGGG -> TGAACATCTCCCCCAGGGC
GACGTAAATCCTGGTCTTG -> ACGTAAATCCTGGTCTTGA
GATTGGACGTAAATCCTGG -> ATTGGACGTAAATCCTGGT
TGCGTCATAGCCAGGCAAC -> GCGTCATAGCCAGGCAACG
ACTGGCCGGGGCGGCCGTT -> CTGGCCGGGGCGGCCGTTA
AGATGGCCATCGCTCGATA -> GATGGCCATCGCTCGATAG
GGCCGGGGCGGCCGTTATA -> GCCGGGGCGGCCGTTATAT
GTCAATGCTGCATCTGTCA -> TCAATGCTGCATCTGTCAG
CCCTCAGCGCTAGACCAGA -> CCTCAGCGCTAGACCAGAT
TCCCCACTCCCTTGTAGGA -> CCCCACTCCCTTGTAGGAC
GCTTATTATATGTGCGGAC -> CTTATTATATGTGCGGACA
TTTGCTGATTGCTAAGGAA -> TTGCTGATTGCTAAGGAAT
GGCGAGCATTCTAAAAGTG -> GCGAGCATTCTAAAAGTGC
GCCAGTGACCTATGATGAG -> CCAGTGACCTATGATGAGG
CCTGTTTCCCTTGCCTAGA -> CTGTTTCCCTTGCCTAGAT
GATTCATGCTGCCCTAAGG -> ATTCATGCTGCCCTAAGGG
TCACGGAGCTGACGCCCCT -> CACGGAGCTGACGCCCCTC
TTGTTACAGCAATCATAAG -> TGTTACAGCAATCATAAGC
TACCCTGGAGAGGCCCACA -> ACCCTGGAGAGGCCCACAT
TACTTGTGAGGAAGCCATA -> ACTTGTGAGGAAGCCATAC
GAGGCCCACATGGCAAAGC -> AGGCCCACATGGCAAAGCA
GCGGCGAACTACTTGTGAG -> CGGCGAACTACTTGTGAGG
GCGCGGCGAACTACTTGTG -> CGCGGCGAACTACTTGTGA
GTAGGACCTCAGAGTATTA -> TAGGACCTCAGAGTATTAC
TGTACGTTCGGGGATTTGC -> GTACGTTCGGGGATTTGCC
CGCGGCGAACTACTTGTGA -> GCGGCGAACTACTTGTGAG
GGATCACAAAAACCCGTGT -> GATCACAAAAACCCGTGTA
CCACTAAGCGTTAAGAACA -> CACTAAGCGTTAAGAACAA
TGGGACTCCAACTTGAGAA -> GGGACTCCAACTTGAGAAC
CCAACCCATCAGCATACCC -> CAACCCATCAGCATACCCT
AGGCCGTTATATTTATTTG -> GGCCGTTATATTTATTTGA
GCCTGCGCAAGATGGAAAA -> CCTGCGCAAGATGGAAAAA
GGAGCAGGGTGGCCCTCAG -> GAGCAGGGTGGCCCTCAGC
TCGATAGGGGTGGTCGACA -> CGATAGGGGTGGTCGACAC
TAGTGTGCCTGTTTCCCTT -> AGTGTGCCTGTTTCCCTTG
CCTCAGAGTATTACCTGCG -> CTCAGAGTATTACCTGCGT
GGTGTCATCTGCGTACAGG -> GTGTCATCTGCGTACAGGT
GCTGCATCTGTCAGCTAGT -> CTGCATCTGTCAGCTAGTG
TCGATCTTGAAACGGGCAA -> CGATCTTGAAACGGGCAAG
CGCTCGATAGTATTCATTC -> GCTCGATAGTATTCATTCT
GCATGAAGGCCTGACTTTC -> CATGAAGGCCTGACTTTCG
CTAATCGCAGGTTAGTCAC -> TAATCGCAGGTTAGTCACG
AGTGTGCCTGTTTCCCTTG -> GTGTGCCTGTTTCCCTTGC
CCGTGCGGGTGTCAGGTTT -> CGTGCGGGTGTCAGGTTTC
CGGTAAGTGGTGGTCGAAT -> GGTAAGTGGTGGTCGAATG
GCCGCAGTGCGTTGCTAAA -> CCGCAGTGCGTTGCTAAAA
TGTGCAGTAAGCCACTAAG -> GTGCAGTAAGCCACTAAGC
AGAACCGGTTTGCAGTTCA -> GAACCGGTTTGCAGTTCAA
TTCCGGTGTCCATCCCGTT -> TCCGGTGTCCATCCCGTTT
ACCCTAGCTCTGTGACCCC -> CCCTAGCTCTGTGACCCCC
CAAGGTACTCCGCTCGCAT -> AAGGTACTCCGCTCGCATA
GTGCCTGTTTCCCTTGCCT -> TGCCTGTTTCCCTTGCCTA
TTTTGCGATCCCGGCTAGA -> TTTGCGATCCCGGCTAGAT
GTGTCTATTCGATCTTGAA -> TGTCTATTCGATCTTGAAA
TGACTGTCACACAGATGGA -> GACTGTCACACAGATGGAA
TCATCTGCGTACAGGTGAA -> CATCTGCGTACAGGTGAAT
GACCCCCAGAGGGTGTCAT -> ACCCCCAGAGGGTGTCATC
CAACTCACTGGGTGTCCCA -> AACTCACTGGGTGTCCCAA
TTATTTGAATTTTGCGACC -> TATTTGAATTTTGCGACCC
TGCTAGCCGGTAGCCACTC -> GCTAGCCGGTAGCCACTCC
CTGGGGATTGGACGTAAAT -> TGGGGATTGGACGTAAATC
GTCAGTACGTATGTCCAAC -> TCAGTACGTATGTCCAACC
GCTAAGGAATACGATGGGT -> CTAAGGAATACGATGGGTT
CCCAGAGGGTGTCATCTGC -> CCAGAGGGTGTCATCTGCG
GAATACCAAGATCACGGAA -> AATACCAAGATCACGGAAA
GATAGACATCTCCGTGAAA -> ATAGACATCTCCGTGAAAC
TGCGTCGTTGCGTACCTCT -> GCGTCGTTGCGTACCTCTA
CCTAGCTCTGTGACCCCCC -> CTAGCTCTGTGACCCCCCC
AAACGCCCTAGTAATTGAG -> AACGCCCTAGTAATTGAGA
GTTTTATCGCGCAGCCGCT -> TTTTATCGCGCAGCCGCTC
GCTAATGTCCGTTCATACG -> CTAATGTCCGTTCATACGG
GGTAGATGTTAAGGTATGC -> GTAGATGTTAAGGTATGCG
TGGGGATTGGACGTAAATC -> GGGGATTGGACGTAAATCC
ACCTCAGAGTATTACCTGC -> CCTCAGAGTATTACCTGCG
ATCTCCCCCAGGGCTTATT -> TCTCCCCCAGGGCTTATTA
GAAAGTGAAAAAGATTGCA -> AAAGTGAAAAAGATTGCAC
AAAGCAGGCGATTGGACCC -> AAGCAGGCGATTGGACCCC
ACCTATGCCTTGCCTGGAG -> CCTATGCCTTGCCTGGAGT
GGCGCATAGCACCGCAAAG -> GCGCATAGCACCGCAAAGT
GTATGGGCGCGACAAAGCC -> TATGGGCGCGACAAAGCCG
ATCACGGAAAATGTAGAAA -> TCACGGAAAATGTAGAAAT
TGTCTATTCGATCTTGAAA -> GTCTATTCGATCTTGAAAC
TGTCATCTGCGTACAGGTG -> GTCATCTGCGTACAGGTGA
AGCACCGCAAAGTTGGAGA -> GCACCGCAAAGTTGGAGAG
CCTGAACATCTCCCCCAGG -> CTGAACATCTCCCCCAGGG
CTGAACCGGCGAGCATTCT -> TGAACCGGCGAGCATTCTA
CTGGAGGGTACTTGATGTG -> TGGAGGGTACTTGATGTGC
CTACCCTAGCTCTGTGACC -> TACCCTAGCTCTGTGACCC
GGGACTGGAGGGTACTTGA -> GGACTGGAGGGTACTTGAT
CCGTCCTCATAACCTATGC -> CGTCCTCATAACCTATGCC
CTTTGCTGATTGCTAAGGA -> TTTGCTGATTGCTAAGGAA
CACTCCCTTGTAGGACCTC -> ACTCCCTTGTAGGACCTCA
ACAAAAGCGGATTGACCAT -> CAAAAGCGGATTGACCATC
AAAAAGATTGCACAAGTAG -> AAAAGATTGCACAAGTAGT
CTTGCTCCCGACCATTTTG -> TTGCTCCCGACCATTTTGA
TGCCTAGATGTACCAAGGC -> GCCTAGATGTACCAAGGCC
GCCTGGAGTATGGGCGCGA -> CCTGGAGTATGGGCGCGAC
TTGCCTGGAGTATGGGCGC -> TGCCTGGAGTATGGGCGCG
AAGAGGCAGATTCGGGTGA -> AGAGGCAGATTCGGGTGAA
CGCCCTAGTAATTGAGACA -> GCCCTAGTAATTGAGACAT
TCTCAGTGTCTATTCGATC -> CTCAGTGTCTATTCGATCT
CTTGTAGGACCTCAGAGTA -> TTGTAGGACCTCAGAGTAT
CCCCCAGAGGGTGTCATCT -> CCCCAGAGGGTGTCATCTG
GAATGCCTTGATTCATGCT -> AATGCCTTGATTCATGCTG
AAACTCACCTGAACATCTC -> AACTCACCTGAACATCTCC
AATTGAGACATCAACTCAC -> ATTGAGACATCAACTCACG
ACATCAACTCACGGAGCTG -> CATCAACTCACGGAGCTGA
AGGTGAATGCCTTGATTCA -> GGTGAATGCCTTGATTCAT
CTTGAGAACTAGTTCAACT -> TTGAGAACTAGTTCAACTC
AGCGGTACGTCAAGTGTAC -> GCGGTACGTCAAGTGTACG
CAACGCCTCTGCAAAACCC -> AACGCCTCTGCAAAACCCT
CTAGATGGCGTCTCAGTGT -> TAGATGGCGTCTCAGTGTC
CTTAAGTGCTAATCGCAGG -> TTAAGTGCTAATCGCAGGT
CCGTGATCTGGAGAACGGC -> CGTGATCTGGAGAACGGCG
CTGCCCTAAGGGGACGAAT -> TGCCCTAAGGGGACGAATT
TCTGCGTACAGGTGAATGC -> CTGCGTACAGGTGAATGCC
TCCCTTGTAGGACCTTAAG -> CCCTTGTAGGACCTTAAGT
TTATATTTATTTGAATTTT -> TATATTTATTTGAATTTTG
AACTACTTGTGAGGAAGCC -> ACTACTTGTGAGGAAGCCA
GCCAAATGGCCGTTATATT -> CCAAATGGCCGTTATATTT
CGGAAGGCGTGCGTCATAG -> GGAAGGCGTGCGTCATAGC
CCTTAAGTGCTAATCGCAG -> CTTAAGTGCTAATCGCAGG
AAAGTTCCGGTGTCCATCC -> AAGTTCCGGTGTCCATCCC
TAAAACTCACCTGAACATC -> AAAACTCACCTGAACATCT
GAATTCGTTTTATCGCGCA -> AATTCGTTTTATCGCGCAG
AAGCGGCCGCACTGTCAAT -> AGCGGCCGCACTGTCAATG
TTGGGGGGCCGTTATATTT -> TGGGGGGCCGTTATATTTA
TCCCGGCTAGATCAAGAAG -> CCCGGCTAGATCAAGAAGG
CCTTGTAGGACCTGGGACT -> CTTGTAGGACCTGGGACTC
GCGTTCCCTGAACCGGCGA -> CGTTCCCTGAACCGGCGAG
CATAGCCAGGCAACGGTTT -> ATAGCCAGGCAACGGTTTT
CAGGGTGGCCCTCAGCGCT -> AGGGTGGCCCTCAGCGCTA
CGGAAAATGTAGAAATAGG -> GGAAAATGTAGAAATAGGA
GGGGACGAATTCGTTTTAT -> GGGACGAATTCGTTTTATC
AATGTAGAAATAGGAGGAG -> ATGTAGAAATAGGAGGAGG
TCGATTCCCTAGATGGCGT -> CGATTCCCTAGATGGCGTC
TTGCTCCCGACCATTTTGA -> TGCTCCCGACCATTTTGAG
CGCCGCAGTGCGTTGCTAA -> GCCGCAGTGCGTTGCTAAA
TTCCTTTGTTACAGCAATC -> TCCTTTGTTACAGCAATCA
TTTATCGCGCAGCCGCTCT -> TTATCGCGCAGCCGCTCTA
TACAGGTGAATGCCTTGAT -> ACAGGTGAATGCCTTGATT
AGAATACCAAGATCACGGA -> GAATACCAAGATCACGGAA
GCCACTCCCTTGTAGGACC -> CCACTCCCTTGTAGGACCT
CAGGTGAATGCCTTGATTC -> AGGTGAATGCCTTGATTCA
TGGGGGGCCGTTATATTTA -> GGGGGGCCGTTATATTTAT
TCATAACCTATGCCTTGCC -> CATAACCTATGCCTTGCCT
CTAAAAGTGCGAAAGTGAA -> TAAAAGTGCGAAAGTGAAA
GATTGCACAAGTAGTGTGG -> ATTGCACAAGTAGTGTGGA
CCTTCCAAACCGTCCTCAT -> CTTCCAAACCGTCCTCATA
CGGGAATCCGAACACCCCT -> GGGAATCCGAACACCCCTT
GCCCAAAAGCATAACGTAG -> CCCAAAAGCATAACGTAGC
GGGCGGCCGTTATATTTAT -> GGCGGCCGTTATATTTATT
TAGCCGGTAGCCACTCCCT -> AGCCGGTAGCCACTCCCTT
TAGCGCGTCGATAGGGGTG -> AGCGCGTCGATAGGGGTGG
ACTCCAGTACAAATGCCCC -> CTCCAGTACAAATGCCCCG
CGGTTTGCAGTTCAAAGAT -> GGTTTGCAGTTCAAAGATA
CTACTTGACTGTCACACAG -> TACTTGACTGTCACACAGA
CTATGATGAGGCGCATAGC -> TATGATGAGGCGCATAGCA
ATTATATGTGCGGACAATT -> TTATATGTGCGGACAATTC
CTGCGTACAGGTGAATGCC -> TGCGTACAGGTGAATGCCT
AAACGGGCAAGAGGCAGAT -> AACGGGCAAGAGGCAGATT
TTATTTGGTCCGTACTCCC -> TATTTGGTCCGTACTCCCC
AATTCTTCCCTTGGCTAAT -> ATTCTTCCCTTGGCTAATG
CAAAGCGGCCGCACTGTCA -> AAAGCGGCCGCACTGTCAA
GACCTCAGAGTATTACCTG -> ACCTCAGAGTATTACCTGC
TGTGACCCCCCCCATATCA -> GTGACCCCCCCCATATCAG
CGATGGGTTAGTATCTTAG -> GATGGGTTAGTATCTTAGG
AAGATGGAAAAAGTGTTCA -> AGATGGAAAAAGTGTTCAC
CCAACACACTGGAGGTTCC -> CAACACACTGGAGGTTCCA
GAGCTTCACACGGTGCGCC -> AGCTTCACACGGTGCGCCT
GCGGTACGTCAAGTGTACG -> CGGTACGTCAAGTGTACGT
CCCCAGGGCTTATTATATG -> CCCAGGGCTTATTATATGT
GGCTTCTCAACGCCTCTGC -> GCTTCTCAACGCCTCTGCA
TATGTTTTGCGATCCCGGC -> ATGTTTTGCGATCCCGGCT
TAGGACCTCAGAGTATTAC -> AGGACCTCAGAGTATTACC
GCAAAGCAGGCGATTGGAC -> CAAAGCAGGCGATTGGACC
CTGGAGAACGGCGTCAGTA -> TGGAGAACGGCGTCAGTAC
TAAGAGCCAAGGATTTTAG -> AAGAGCCAAGGATTTTAGC
GCCAAGGATTTTAGCGCGT -> CCAAGGATTTTAGCGCGTC
ACTGGCTCCAACGAAGGCG -> CTGGCTCCAACGAAGGCGC
TGGACTCCAGTACAAATGC -> GGACTCCAGTACAAATGCC
TAATGAACTTAGTAGGTCT -> AATGAACTTAGTAGGTCTA
CTATTCGATCTTGAAACGG -> TATTCGATCTTGAAACGGG
ATGCCCCGCACCCTTCCAA -> TGCCCCGCACCCTTCCAAA
AAAAGTGTTCACTGGCTTC -> AAAGTGTTCACTGGCTTCT
TGCTCTGGGGATTGGACGT -> GCTCTGGGGATTGGACGTA
GATCTTGAAACGGGCAAGA -> ATCTTGAAACGGGCAAGAG
GCTCTACTTGACTGTCACA -> CTCTACTTGACTGTCACAC
TCGCAGGTTAGTCACGGAG -> CGCAGGTTAGTCACGGAGT
CTAGATCAAGAAGGCCTTT -> TAGATCAAGAAGGCCTTTA
AGGACCTCAGAGTATTACC -> GGACCTCAGAGTATTACCT
GTGCGAAAGTGAAAAAGAT -> TGCGAAAGTGAAAAAGATT
AGTATCTTAGGGCGTTCAA -> GTATCTTAGGGCGTTCAAC
TGGTCGACACTACCCTAGC -> GGTCGACACTACCCTAGCT
TAGTACACACGTATGTTTT -> AGTACACACGTATGTTTTG
ACATGGTGGGAACACAAGG -> CATGGTGGGAACACAAGGT
GCACCGTTCAAAACGGACA -> CACCGTTCAAAACGGACAA
TCGCTACTGTCCAATGCGG -> CGCTACTGTCCAATGCGGG
GAGCCAAGGATTTTAGCGC -> AGCCAAGGATTTTAGCGCG
GTCACGGAGTGAATTTACG -> TCACGGAGTGAATTTACGG
GGTGTCCATCCCGTTTTCG -> GTGTCCATCCCGTTTTCGA
CCCTTGTAGGACCTTAAGT -> CCTTGTAGGACCTTAAGTG
GTACGTTCGGGGATTTGCC -> TACGTTCGGGGATTTGCCC
GAGAGTGACCGACAAAGTT -> AGAGTGACCGACAAAGTTC
CACTGGGTGTCCCAACTAT -> ACTGGGTGTCCCAACTATT
TATTTATTTGGTCCGTACT -> ATTTATTTGGTCCGTACTC
GGAACACAAGGTACTCCGC -> GAACACAAGGTACTCCGCT
TAGGTCTAGGGCGATACCC -> AGGTCTAGGGCGATACCCG
TGCCTAGTACACACGTATG -> GCCTAGTACACACGTATGT
GTAGTGTGGAGTTTCCCAC -> TAGTGTGGAGTTTCCCACT
TGAGGGGCACCAACACACT -> GAGGGGCACCAACACACTG
CTGCAAAACCCTCTTGCCT -> TGCAAAACCCTCTTGCCTA
CCAGAGGGTGTCATCTGCG -> CAGAGGGTGTCATCTGCGT
AGTTCAAAGATAGACATCT -> GTTCAAAGATAGACATCTC
TCAGGTTTCGACAGTTGGT -> CAGGTTTCGACAGTTGGTA
TGAATCTCCGAAGTGAGCC -> GAATCTCCGAAGTGAGCCA
GGAGCTGACGCCCCTCCTA -> GAGCTGACGCCCCTCCTAG
TATTGAATCTCCGAAGTGA -> ATTGAATCTCCGAAGTGAG
TGCTGCATCTGTCAGCTAG -> GCTGCATCTGTCAGCTAGT
ATTCTGGTACTGATTCCTT -> TTCTGGTACTGATTCCTTT
AAACCCTCTTGCCTAGTAC -> AACCCTCTTGCCTAGTACA
CTCCCTTGTAGGACCTGGG -> TCCCTTGTAGGACCTGGGA
ATCTTAGGGCGTTCAACAT -> TCTTAGGGCGTTCAACATC
TTCTTCCCTTGGCTAATGT -> TCTTCCCTTGGCTAATGTC
GCAAGATGGAAAAAGTGTT -> CAAGATGGAAAAAGTGTTC
GCTCGGTAAGTGGTGGTCG -> CTCGGTAAGTGGTGGTCGA
CTAAGGAATACGATGGGTT -> TAAGGAATACGATGGGTTA
GTACTCCGCTCGCATAATG -> TACTCCGCTCGCATAATGA
GGAATACGATGGGTTAGTA -> GAATACGATGGGTTAGTAT
TGTCAGGTTTCGACAGTTG -> GTCAGGTTTCGACAGTTGG
GTTTCCCTTGCCTAGATGT -> TTTCCCTTGCCTAGATGTA
GGGACTCCAACTTGAGAAC -> GGACTCCAACTTGAGAACT
GAGGATGCCCCACTGGCTC -> AGGATGCCCCACTGGCTCC
TGGTGGTCGAATGCTCTGG -> GGTGGTCGAATGCTCTGGG
AGCAATCATAAGCCAGTGA -> GCAATCATAAGCCAGTGAC
GACCTGTAGCACCGTTCAA -> ACCTGTAGCACCGTTCAAA
TGCGCTGAGGGGCACCAAC -> GCGCTGAGGGGCACCAACA
CTCCGCTCGCATAATGAAC -> TCCGCTCGCATAATGAACT
CTAGCCGGTAGCCACTCCC -> TAGCCGGTAGCCACTCCCT
AGCTCTGTGACCCCCCCCA -> GCTCTGTGACCCCCCCCAT
CAAAAGCGGATTGACCATC -> AAAAGCGGATTGACCATCC
AATGCCTTGATTCATGCTG -> ATGCCTTGATTCATGCTGC
AGGGTCCACGCCCAAAAGC -> GGGTCCACGCCCAAAAGCA
GTAGATGTTAAGGTATGCG -> TAGATGTTAAGGTATGCGC
TCTATTCGATCTTGAAACG -> CTATTCGATCTTGAAACGG
TTTGTTACAGCAATCATAA -> TTGTTACAGCAATCATAAG
CCCTTGTAGGACCTCAGAG -> CCTTGTAGGACCTCAGAGT
GAAGGCCTGACTTTCGTGG -> AAGGCCTGACTTTCGTGGC
GCCGGGGCGGCCGTTATAT -> CCGGGGCGGCCGTTATATT
TAGTATCTTAGGGCGTTCA -> AGTATCTTAGGGCGTTCAA
AACGGACATGGTGGGAACA -> ACGGACATGGTGGGAACAC
CAACTATTGAATCTCCGAA -> AACTATTGAATCTCCGAAG
AGGGTACTTGATGTGCAGT -> GGGTACTTGATGTGCAGTA
TTGCTAAGGAATACGATGG -> TGCTAAGGAATACGATGGG
CTAGATGTACCAAGGCCGT -> TAGATGTACCAAGGCCGTT
TTGGTAGATGTTAAGGTAT -> TGGTAGATGTTAAGGTATG
GTTGCGTACCTCTATATCT -> TTGCGTACCTCTATATCTT
GATTTTAGCGCGTCGATAG -> ATTTTAGCGCGTCGATAGG
GATGCCCCACTGGCTCCAA -> ATGCCCCACTGGCTCCAAC
GCAGTAAGCCACTAAGCGT -> CAGTAAGCCACTAAGCGTT
GTGATCTGGAGAACGGCGT -> TGATCTGGAGAACGGCGTC
GGTGGGTTGAGGGTCCACG -> GTGGGTTGAGGGTCCACGC
AGTAGGTCTAGGGCGATAC -> GTAGGTCTAGGGCGATACC
CCCTAAGGGGACGAATTCG -> CCTAAGGGGACGAATTCGT
GTCCGTACTCCCCACTCCC -> TCCGTACTCCCCACTCCCT
GCGATCCCGGCTAGATCAA -> CGATCCCGGCTAGATCAAG
ACCAACACACTGGAGGTTC -> CCAACACACTGGAGGTTCC
ACCTGGGACTCCAACTTGA -> CCTGGGACTCCAACTTGAG
GGATTGGACGTAAATCCTG -> GATTGGACGTAAATCCTGG
AACTTGAGAACTAGTTCAA -> ACTTGAGAACTAGTTCAAC
GCATACCCTGGAGAGGCCC -> CATACCCTGGAGAGGCCCA
ACATGGCAAAGCAGGCGAT -> CATGGCAAAGCAGGCGATT
GGTTGATGCGTCGTTGCGT -> GTTGATGCGTCGTTGCGTA
CGGTGCGCCTGCGCAAGAT -> GGTGCGCCTGCGCAAGATG
AGACCAGATGGCCATCGCT -> GACCAGATGGCCATCGCTC
TCATTCTGGTGGGTTGAGG -> CATTCTGGTGGGTTGAGGG
CATATCAGCGAATCCGTGC -> ATATCAGCGAATCCGTGCA
CATAACCTATGCCTTGCCT -> ATAACCTATGCCTTGCCTG
ATGGGCGCGACAAAGCCGG -> TGGGCGCGACAAAGCCGGG
AGATAGACATCTCCGTGAA -> GATAGACATCTCCGTGAAA
TGCTGATTGCTAAGGAATA -> GCTGATTGCTAAGGAATAC
ACCAGATGGCCATCGCTCG -> CCAGATGGCCATCGCTCGA
GCTGGCGCCGCAGTGCGTT -> CTGGCGCCGCAGTGCGTTG
ATATCAGCGAATCCGTGCA -> TATCAGCGAATCCGTGCAG
CTTGCCTAGATGTACCAAG -> TTGCCTAGATGTACCAAGG
CTTCCCTTGGCTAATGTCC -> TTCCCTTGGCTAATGTCCG
TTGAGAACTAGTTCAACTC -> TGAGAACTAGTTCAACTCA
AACCTATGCCTTGCCTGGA -> ACCTATGCCTTGCCTGGAG
GACCTTAAGTGCTAATCGC -> ACCTTAAGTGCTAATCGCA
GGCGTGCGTCATAGCCAGG -> GCGTGCGTCATAGCCAGGC
CGGGTGAACGGACATGGTG -> GGGTGAACGGACATGGTGG
AAAACGGACAAAAGCGGAT -> AAACGGACAAAAGCGGATT
GCCCTAGTAATTGAGACAT -> CCCTAGTAATTGAGACATC
AAGAAGGCCTTTACAATTG -> AGAAGGCCTTTACAATTGG
CCTGCGTTCCCTGAACCGG -> CTGCGTTCCCTGAACCGGC
TTCGAGGTCACGTCGCTAC -> TCGAGGTCACGTCGCTACT
AGCCAGGCAACGGTTTTCC -> GCCAGGCAACGGTTTTCCT
CGCATAATGAACTTAGTAG -> GCATAATGAACTTAGTAGG
ACACACTGGAGGTTCCATT -> CACACTGGAGGTTCCATTC
GGCCCACATGGCAAAGCAG -> GCCCACATGGCAAAGCAGG
CTTGCCTGGAGTATGGGCG -> TTGCCTGGAGTATGGGCGC
AACGGTTTTCCTAATTTCC -> ACGGTTTTCCTAATTTCCT
GGCAACGGTTTTCCTAATT -> GCAACGGTTTTCCTAATTT
CTCCGAAGTGAGCCAAATG -> TCCGAAGTGAGCCAAATGG
CAAGTAGTGTGGAGTTTCC -> AAGTAGTGTGGAGTTTCCC
GCCAGGCAACGGTTTTCCT -> CCAGGCAACGGTTTTCCTA
CCCACTAAGACTTAGAATA -> CCACTAAGACTTAGAATAC
AATCTCCGAAGTGAGCCAA -> ATCTCCGAAGTGAGCCAAA
AGAGGCCCACATGGCAAAG -> GAGGCCCACATGGCAAAGC
CGACACTACCCTAGCTCTG -> GACACTACCCTAGCTCTGT
CTTTTGGGGGGCCGTTATA -> TTTTGGGGGGCCGTTATAT
CAAGGATTTTAGCGCGTCG -> AAGGATTTTAGCGCGTCGA
GTTGAGGGTCCACGCCCAA -> TTGAGGGTCCACGCCCAAA
TGAACCGGCGAGCATTCTA -> GAACCGGCGAGCATTCTAA
ACCCGGAGCAGGGTGGCCC -> CCCGGAGCAGGGTGGCCCT
TTGCCCCGTGCGGGTGTCA -> TGCCCCGTGCGGGTGTCAG
AAAAAGTGTTCACTGGCTT -> AAAAGTGTTCACTGGCTTC
CCTCTTGCCTAGTACACAC -> CTCTTGCCTAGTACACACG
GTGCGGACAATTCTTCCCT -> TGCGGACAATTCTTCCCTT
CAACTCACGGAGCTGACGC -> AACTCACGGAGCTGACGCC
GCGCTAGACCAGATGGCCA -> CGCTAGACCAGATGGCCAT
AAGCATGAAGGCCTGACTT -> AGCATGAAGGCCTGACTTT
CGATACCCGGAGCAGGGTG -> GATACCCGGAGCAGGGTGG
TTATATTTATTTGTGCAGA -> TATATTTATTTGTGCAGAG
CGAATCCGTGCAGGAAACA -> GAATCCGTGCAGGAAACAA
GACAATTCTTCCCTTGGCT -> ACAATTCTTCCCTTGGCTA
TGTCCAACCCATCAGCATA -> GTCCAACCCATCAGCATAC
TAAGGGGACGAATTCGTTT -> AAGGGGACGAATTCGTTTT
GCCTCTGCAAAACCCTCTT -> CCTCTGCAAAACCCTCTTG
GGGCGCGACAAAGCCGGGG -> GGCGCGACAAAGCCGGGGC
GCCTTGCCTGGAGTATGGG -> CCTTGCCTGGAGTATGGGC
GAGAACGGCGTCAGTACGT -> AGAACGGCGTCAGTACGTA
GGGGTGGTCGACACTACCC -> GGGTGGTCGACACTACCCT
GCCCACATGGCAAAGCAGG -> CCCACATGGCAAAGCAGGC
TATTCTGGTACTGATTCCT -> ATTCTGGTACTGATTCCTT
TGAGAACCGGTTTGCAGTT -> GAGAACCGGTTTGCAGTTC
ATGGCCATCGCTCGATAGT -> TGGCCATCGCTCGATAGTA
GTAGGTCTAGGGCGATACC -> TAGGTCTAGGGCGATACCC
AGGCGATTGGACCCCCAGA -> GGCGATTGGACCCCCAGAG
CATAGCACCGCAAAGTTGG -> ATAGCACCGCAAAGTTGGA
TTCTCAACGCCTCTGCAAA -> TCTCAACGCCTCTGCAAAA
GGTTTCGACAGTTGGTAGA -> GTTTCGACAGTTGGTAGAT
AAGGTATGCGCTGAGGGGC -> AGGTATGCGCTGAGGGGCA
CCGGAGCAGGGTGGCCCTC -> CGGAGCAGGGTGGCCCTCA
GACCGACAAAGTTCCGGTG -> ACCGACAAAGTTCCGGTGT
CATCGCTCGATAGTATTCA -> ATCGCTCGATAGTATTCAT
TTGAGACATCAACTCACGG -> TGAGACATCAACTCACGGA
CAATGCTGCATCTGTCAGC -> AATGCTGCATCTGTCAGCT
CCATATCAGCGAATCCGTG -> CATATCAGCGAATCCGTGC
GGACGTAAATCCTGGTCTT -> GACGTAAATCCTGGTCTTG
GCTGCCCTAAGGGGACGAA -> CTGCCCTAAGGGGACGAAT
AGTATATTCTGGTACTGAT -> GTATATTCTGGTACTGATT
GTGACCTATGATGAGGCGC -> TGACCTATGATGAGGCGCA
CACTCCCTTGTAGGACCTT -> ACTCCCTTGTAGGACCTTA
CGTCTCAGTGTCTATTCGA -> GTCTCAGTGTCTATTCGAT
GAAACAAAGCGGCCGCACT -> AAACAAAGCGGCCGCACTG
GGAGAGTGACCGACAAAGT -> GAGAGTGACCGACAAAGTT
GTGGTGGTCGAATGCTCTG -> TGGTGGTCGAATGCTCTGG
AGCTAGTGTGCCTGTTTCC -> GCTAGTGTGCCTGTTTCCC
CTTGTAGGACCTTAAGTGC -> TTGTAGGACCTTAAGTGCT
AACGCCTCTGCAAAACCCT -> ACGCCTCTGCAAAACCCTC
CAGCATACCCTGGAGAGGC -> AGCATACCCTGGAGAGGCC
GTGACCGACAAAGTTCCGG -> TGACCGACAAAGTTCCGGT
TTGTAGGACCTGGGACTCC -> TGTAGGACCTGGGACTCCA
AAATAGGAGGAGGGGACTG -> AATAGGAGGAGGGGACTGG
AAGATAGACATCTCCGTGA -> AGATAGACATCTCCGTGAA
GCGCGACAAAGCCGGGGCT -> CGCGACAAAGCCGGGGCTT
AGGCAGATTCGGGTGAACG -> GGCAGATTCGGGTGAACGG
TGATTCATGCTGCCCTAAG -> GATTCATGCTGCCCTAAGG
CAAATGGCCGTTATATTTA -> AAATGGCCGTTATATTTAT
CCGGTAGCCACTCCCTTGT -> CGGTAGCCACTCCCTTGTA
CGTCGATAGGGGTGGTCGA -> GTCGATAGGGGTGGTCGAC
TCCACTCCCTTGTAGGACC -> CCACTCCCTTGTAGGACCT
CCCGTTTTCGAGGTCACGT -> CCGTTTTCGAGGTCACGTC
GCCCCTCGATTCCCTAGAT -> CCCCTCGATTCCCTAGATG
GGGTGTCAGGTTTCGACAG -> GGTGTCAGGTTTCGACAGT
TTTACAATTGGATCACAAA -> TTACAATTGGATCACAAAA
GTGAAAAAGATTGCACAAG -> TGAAAAAGATTGCACAAGT
GATTCGGGTGAACGGACAT -> ATTCGGGTGAACGGACATG
CACTGGCTCCAACGAAGGC -> ACTGGCTCCAACGAAGGCG
GTGAACGGACATGGTGGGA -> TGAACGGACATGGTGGGAA
CTCCCTTGTAGGACCTTAA -> TCCCTTGTAGGACCTTAAG
GAAGTGAGCCAAATGGCCG -> AAGTGAGCCAAATGGCCGT
TTATAATACGCGGCAGGTT -> TATAATACGCGGCAGGTTG
TTATATTTATTTGCTAGCC -> TATATTTATTTGCTAGCCG
CTGTCCAATGCGGGAATCC -> TGTCCAATGCGGGAATCCG
GTATTCATTCTGGTGGGTT -> TATTCATTCTGGTGGGTTG
GTATTTGAGGATGCCCCAC -> TATTTGAGGATGCCCCACT
TGCAGTTCAAAGATAGACA -> GCAGTTCAAAGATAGACAT
CATGGTGGGAACACAAGGT -> ATGGTGGGAACACAAGGTA
GCCCCTCCTAGACGCTGGC -> CCCCTCCTAGACGCTGGCG
ATCACAAAAACCCGTGTAT -> TCACAAAAACCCGTGTATT
GATGGAAAAAGTGTTCACT -> ATGGAAAAAGTGTTCACTG
AGGTTGATGCGTCGTTGCG -> GGTTGATGCGTCGTTGCGT
TATCGCGCAGCCGCTCTAC -> ATCGCGCAGCCGCTCTACT
GGTGTCCCAACTATTGAAT -> GTGTCCCAACTATTGAATC
ACGAAGGCGCGGCGAACTA -> CGAAGGCGCGGCGAACTAC
CTATGCCTTGCCTGGAGTA -> TATGCCTTGCCTGGAGTAT
GGCACCAACACACTGGAGG -> GCACCAACACACTGGAGGT
CTTGTGAGGAAGCCATACC -> TTGTGAGGAAGCCATACCG
ATAACGTAGCTGGACTCCA -> TAACGTAGCTGGACTCCAG
TCTCCCCCAGGGCTTATTA -> CTCCCCCAGGGCTTATTAT
TTGACTGTCACACAGATGG -> TGACTGTCACACAGATGGA
TGTTACAGCAATCATAAGC -> GTTACAGCAATCATAAGCC
TGAAACGGGCAAGAGGCAG -> GAAACGGGCAAGAGGCAGA
CCATCGCTCGATAGTATTC -> CATCGCTCGATAGTATTCA
GGCCGTTATATTTATTTGG -> GCCGTTATATTTATTTGGT
CCTTTACAATTGGATCACA -> CTTTACAATTGGATCACAA
AGTACACACGTATGTTTTG -> GTACACACGTATGTTTTGC
TACCCGGAGCAGGGTGGCC -> ACCCGGAGCAGGGTGGCCC
GCTCTGGGGATTGGACGTA -> CTCTGGGGATTGGACGTAA
ACCGGCGAGCATTCTAAAA -> CCGGCGAGCATTCTAAAAG
GGTCTAGGGCGATACCCGG -> GTCTAGGGCGATACCCGGA
CGTCGTTGCGTACCTCTAT -> GTCGTTGCGTACCTCTATA
TATTATATGTGCGGACAAT -> ATTATATGTGCGGACAATT
GGGGCCGTTATATTTATTT -> GGGCCGTTATATTTATTTG
ACCATCCGCTCGGTAAGTG -> CCATCCGCTCGGTAAGTGG
AGATCAAGAAGGCCTTTAC -> GATCAAGAAGGCCTTTACA
AACGAAGGCGCGGCGAACT -> ACGAAGGCGCGGCGAACTA
GGAGAACGGCGTCAGTACG -> GAGAACGGCGTCAGTACGT
GACCCCCCCCATATCAGCG -> ACCCCCCCCATATCAGCGA
CAGGCAACGGTTTTCCTAA -> AGGCAACGGTTTTCCTAAT
GTTAAGGTATGCGCTGAGG -> TTAAGGTATGCGCTGAGGG
GATTGCTAAGGAATACGAT -> ATTGCTAAGGAATACGATG
GAATTCCACTCCCTTGTAG -> AATTCCACTCCCTTGTAGG
ATCTTGAAACGGGCAAGAG -> TCTTGAAACGGGCAAGAGG
ATTTATTTGTGCAGAGAAT -> TTTATTTGTGCAGAGAATT
TATTCGATCTTGAAACGGG -> ATTCGATCTTGAAACGGGC
CCAGTACAAATGCCCCGCA -> CAGTACAAATGCCCCGCAC
CAGGTTGATGCGTCGTTGC -> AGGTTGATGCGTCGTTGCG
GTACACACGTATGTTTTGC -> TACACACGTATGTTTTGCG
TTCCTAATTTCCTTTGTTA -> TCCTAATTTCCTTTGTTAC
GCGGCCGTTATATTTATTT -> CGGCCGTTATATTTATTTG
AGCCGCTCTACTTGACTGT -> GCCGCTCTACTTGACTGTC
GAATTTACGGGCGAAGAAG -> AATTTACGGGCGAAGAAGT
AAGTGAGCCAAATGGCCGT -> AGTGAGCCAAATGGCCGTT
CCGCTCTACTTGACTGTCA -> CGCTCTACTTGACTGTCAC
TCTGGGGATTGGACGTAAA -> CTGGGGATTGGACGTAAAT
CTGGCTCCAACGAAGGCGC -> TGGCTCCAACGAAGGCGCG
AAAACCCTCTTGCCTAGTA -> AAACCCTCTTGCCTAGTAC
TCCCTTGTAGGACCTGTAG -> CCCTTGTAGGACCTGTAGC
TGATGAGGCGCATAGCACC -> GATGAGGCGCATAGCACCG
GTTGCCCCGTGCGGGTGTC -> TTGCCCCGTGCGGGTGTCA
ACAAAGTTCCGGTGTCCAT -> CAAAGTTCCGGTGTCCATC
GCAAGAGGCAGATTCGGGT -> CAAGAGGCAGATTCGGGTG
AGGATGCCCCACTGGCTCC -> GGATGCCCCACTGGCTCCA
CTAGACGCTGGCGCCGCAG -> TAGACGCTGGCGCCGCAGT
GTTGGAGAGTGACCGACAA -> TTGGAGAGTGACCGACAAA
CCTGGGACTCCAACTTGAG -> CTGGGACTCCAACTTGAGA
TGGCGCCGCAGTGCGTTGC -> GGCGCCGCAGTGCGTTGCT
TAGACGCTGGCGCCGCAGT -> AGACGCTGGCGCCGCAGTG
CCATTTTGAGAACCGGTTT -> CATTTTGAGAACCGGTTTG
GCGTCATAGCCAGGCAACG -> CGTCATAGCCAGGCAACGG
AGGGGACGAATTCGTTTTA -> GGGGACGAATTCGTTTTAT
TTTTGAGAACCGGTTTGCA -> TTTGAGAACCGGTTTGCAG
GGGGCGGCCGTTATATTTA -> GGGCGGCCGTTATATTTAT
CCCGGAGCAGGGTGGCCCT -> CCGGAGCAGGGTGGCCCTC
GTCACACAGATGGAAGCAT -> TCACACAGATGGAAGCATG
GCTTGCTCCCGACCATTTT -> CTTGCTCCCGACCATTTTG
GAGAACCGGTTTGCAGTTC -> AGAACCGGTTTGCAGTTCA
GGGTGTCATCTGCGTACAG -> GGTGTCATCTGCGTACAGG
TGGCTCCAACGAAGGCGCG -> GGCTCCAACGAAGGCGCGG
TAGTAATTGAGACATCAAC -> AGTAATTGAGACATCAACT
CCGTCTCATGATAAGCGGT -> CGTCTCATGATAAGCGGTA
GTGTCCATCCCGTTTTCGA -> TGTCCATCCCGTTTTCGAG
TGTGCAGAGAATTCCACTC -> GTGCAGAGAATTCCACTCC
GTCTCAGTGTCTATTCGAT -> TCTCAGTGTCTATTCGATC
GGTAAGTGGTGGTCGAATG -> GTAAGTGGTGGTCGAATGC
GTTTTCCTAATTTCCTTTG -> TTTTCCTAATTTCCTTTGT
GGAGGAGGGGACTGGAGGG -> GAGGAGGGGACTGGAGGGT
ATTGAATCTCCGAAGTGAG -> TTGAATCTCCGAAGTGAGC
TGGGTTGAGGGTCCACGCC -> GGGTTGAGGGTCCACGCCC
TCCGAAGTGAGCCAAATGG -> CCGAAGTGAGCCAAATGGC
CCGACAAAGTTCCGGTGTC -> CGACAAAGTTCCGGTGTCC
GGGGCTTGCTCCCGACCAT -> GGGCTTGCTCCCGACCATT
TGGAGAGGCCCACATGGCA -> GGAGAGGCCCACATGGCAA
AATTGGATCACAAAAACCC -> ATTGGATCACAAAAACCCG
CCCTCGATTCCCTAGATGG -> CCTCGATTCCCTAGATGGC
CTGACGCCCCTCCTAGACG -> TGACGCCCCTCCTAGACGC
CCTGGAGAGGCCCACATGG -> CTGGAGAGGCCCACATGGC
GTCCAATGCGGGAATCCGA -> TCCAATGCGGGAATCCGAA
AGCTGACGCCCCTCCTAGA -> GCTGACGCCCCTCCTAGAC
ACCCTGGAGAGGCCCACAT -> CCCTGGAGAGGCCCACATG
TTATTTGCTAGCCGGTAGC -> TATTTGCTAGCCGGTAGCC
CCCCGTGCGGGTGTCAGGT -> CCCGTGCGGGTGTCAGGTT
TAGGGGTGGTCGACACTAC -> AGGGGTGGTCGACACTACC
GGTGGCCCTCAGCGCTAGA -> GTGGCCCTCAGCGCTAGAC
GCATAATGAACTTAGTAGG -> CATAATGAACTTAGTAGGT
GGATTGACCATCCGCTCGG -> GATTGACCATCCGCTCGGT
TCTCCGAAGTGAGCCAAAT -> CTCCGAAGTGAGCCAAATG
GGCACTGGCCGGGGCGGCC -> GCACTGGCCGGGGCGGCCG
GCCACTAAGCGTTAAGAAC -> CCACTAAGCGTTAAGAACA
GCCCCACTGGCTCCAACGA -> CCCCACTGGCTCCAACGAA
CTTAGAATACCAAGATCAC -> TTAGAATACCAAGATCACG
TTTCCCACTAAGACTTAGA -> TTCCCACTAAGACTTAGAA
AACTCACCTGAACATCTCC -> ACTCACCTGAACATCTCCC
CGGGGCGGCCGTTATATTT -> GGGGCGGCCGTTATATTTA
GAATACGATGGGTTAGTAT -> AATACGATGGGTTAGTATC
CGGGCGAAGAAGTATATTC -> GGGCGAAGAAGTATATTCT
GCAGCCGCTCTACTTGACT -> CAGCCGCTCTACTTGACTG
CCCCGCACCCTTCCAAACC -> CCCGCACCCTTCCAAACCG
GTTATATTTATTTGAATTT -> TTATATTTATTTGAATTTT
TATATTTATTTGAATTTTG -> ATATTTATTTGAATTTTGC
CGAATTCGTTTTATCGCGC -> GAATTCGTTTTATCGCGCA
GCGAGCATTCTAAAAGTGC -> CGAGCATTCTAAAAGTGCG
TTGCCTAGTACACACGTAT -> TGCCTAGTACACACGTATG
GTGTATTTGAGGATGCCCC -> TGTATTTGAGGATGCCCCA
GCGCCTGCGCAAGATGGAA -> CGCCTGCGCAAGATGGAAA
AGGGCGTTCAACATCCGTC -> GGGCGTTCAACATCCGTCT
ACTTAGAATACCAAGATCA -> CTTAGAATACCAAGATCAC
AGTGCGTTGCTAAAACTCA -> GTGCGTTGCTAAAACTCAC
CAAAGCCGGGGCTTGCTCC -> AAAGCCGGGGCTTGCTCCC
TCAAAACGGACAAAAGCGG -> CAAAACGGACAAAAGCGGA
GACTTAGAATACCAAGATC -> ACTTAGAATACCAAGATCA
TCTTGACTATTTACTTATA -> CTTGACTATTTACTTATAA
TTATATGTGCGGACAATTC -> TATATGTGCGGACAATTCT
AAGTTGGAGAGTGACCGAC -> AGTTGGAGAGTGACCGACA
CGTGGCACTGGCCGGGGCG -> GTGGCACTGGCCGGGGCGG
CCAACTATTGAATCTCCGA -> CAACTATTGAATCTCCGAA
GTCGATAGGGGTGGTCGAC -> TCGATAGGGGTGGTCGACA
CTTCCAAACCGTCCTCATA -> TTCCAAACCGTCCTCATAA
AGAAGTATATTCTGGTACT -> GAAGTATATTCTGGTACTG
TTTGGGGGGCCGTTATATT -> TTGGGGGGCCGTTATATTT
AAGCCATACCGTGATCTGG -> AGCCATACCGTGATCTGGA
AATCCGTGCAGGAAACAAA -> ATCCGTGCAGGAAACAAAG
AATACGCGGCAGGTTGATG -> ATACGCGGCAGGTTGATGC
TGAGCCAAATGGCCGTTAT -> GAGCCAAATGGCCGTTATA
CGCAGGTTAGTCACGGAGT -> GCAGGTTAGTCACGGAGTG
GGGAATCCGAACACCCCTT -> GGAATCCGAACACCCCTTA
AATCGCAGGTTAGTCACGG -> ATCGCAGGTTAGTCACGGA
CATCCGCTCGGTAAGTGGT -> ATCCGCTCGGTAAGTGGTG
CTCGATTCCCTAGATGGCG -> TCGATTCCCTAGATGGCGT
TGCTAATCGCAGGTTAGTC -> GCTAATCGCAGGTTAGTCA
GTAGCTGGACTCCAGTACA -> TAGCTGGACTCCAGTACAA
TCTCATGATAAGCGGTACG -> CTCATGATAAGCGGTACGT
TCCAACCCATCAGCATACC -> CCAACCCATCAGCATACCC
CGTCGCTACTGTCCAATGC -> GTCGCTACTGTCCAATGCG
GGCCGTTATATTTATTTGT -> GCCGTTATATTTATTTGTG
TGGGCGCGACAAAGCCGGG -> GGGCGCGACAAAGCCGGGG
AAAGATAGACATCTCCGTG -> AAGATAGACATCTCCGTGA
CTGTTTCCCTTGCCTAGAT -> TGTTTCCCTTGCCTAGATG
CTTCTCAACGCCTCTGCAA -> TTCTCAACGCCTCTGCAAA
CACCTGAACATCTCCCCCA -> ACCTGAACATCTCCCCCAG
AGACTTAGAATACCAAGAT -> GACTTAGAATACCAAGATC
ATTTTGCGACCCACTCCCT -> TTTTGCGACCCACTCCCTT
AACGGACAAAAGCGGATTG -> ACGGACAAAAGCGGATTGA
CCTGTAGCACCGTTCAAAA -> CTGTAGCACCGTTCAAAAC
GCCATCGCTCGATAGTATT -> CCATCGCTCGATAGTATTC
TAAGGTATGCGCTGAGGGG -> AAGGTATGCGCTGAGGGGC
TTGGATCACAAAAACCCGT -> TGGATCACAAAAACCCGTG
CGAGCATTCTAAAAGTGCG -> GAGCATTCTAAAAGTGCGA
GCTTTTGGGGGGCCGTTAT -> CTTTTGGGGGGCCGTTATA
GTTGGTAGATGTTAAGGTA -> TTGGTAGATGTTAAGGTAT
TCATAAGCCAGTGACCTAT -> CATAAGCCAGTGACCTATG
CCCCTCCTAGACGCTGGCG -> CCCTCCTAGACGCTGGCGC
GAGGGTCCACGCCCAAAAG -> AGGGTCCACGCCCAAAAGC
GGCCTTTACAATTGGATCA -> GCCTTTACAATTGGATCAC
CGCCTCTGCAAAACCCTCT -> GCCTCTGCAAAACCCTCTT
CTACTGTCCAATGCGGGAA -> TACTGTCCAATGCGGGAAT
GGACTGGAGGGTACTTGAT -> GACTGGAGGGTACTTGATG
GCTAATCGCAGGTTAGTCA -> CTAATCGCAGGTTAGTCAC
ATCTCCGAAGTGAGCCAAA -> TCTCCGAAGTGAGCCAAAT
GTGGGAACACAAGGTACTC -> TGGGAACACAAGGTACTCC
CAACGAAGGCGCGGCGAAC -> AACGAAGGCGCGGCGAACT
TGCGTACCTCTATATCTTT -> GCGTACCTCTATATCTTTG
CGTTATATTTATTTGCTAG -> GTTATATTTATTTGCTAGC
TACGGGCGAAGAAGTATAT -> ACGGGCGAAGAAGTATATT
ACGCGGCAGGTTGATGCGT -> CGCGGCAGGTTGATGCGTC
ATAGCACCGCAAAGTTGGA -> TAGCACCGCAAAGTTGGAG
GACTCCAGTACAAATGCCC -> ACTCCAGTACAAATGCCCC
AAAAGCGGATTGACCATCC -> AAAGCGGATTGACCATCCG
AGATTGCACAAGTAGTGTG -> GATTGCACAAGTAGTGTGG
AATTCCACTCCCTTGTAGG -> ATTCCACTCCCTTGTAGGA
GCAGAGAATTCCACTCCCT -> CAGAGAATTCCACTCCCTT
GCTTCACACGGTGCGCCTG -> CTTCACACGGTGCGCCTGC
CCGTTCAAAACGGACAAAA -> CGTTCAAAACGGACAAAAG
GTGAAACGCCCTAGTAATT -> TGAAACGCCCTAGTAATTG
GTTGCTAAAACTCACCTGA -> TTGCTAAAACTCACCTGAA
GTGTCATCTGCGTACAGGT -> TGTCATCTGCGTACAGGTG
TTCATACGGTTGCTTTTGG -> TCATACGGTTGCTTTTGGG
TTGCGTACCTCTATATCTT -> TGCGTACCTCTATATCTTT
TTCCCTGAACCGGCGAGCA -> TCCCTGAACCGGCGAGCAT
TGGCAAAGCAGGCGATTGG -> GGCAAAGCAGGCGATTGGA
TCGTGGCACTGGCCGGGGC -> CGTGGCACTGGCCGGGGCG
TTTGGTCCGTACTCCCCAC -> TTGGTCCGTACTCCCCACT
GACAAAGCCGGGGCTTGCT -> ACAAAGCCGGGGCTTGCTC
ACTTGATGTGCAGTAAGCC -> CTTGATGTGCAGTAAGCCA
CATGGCAAAGCAGGCGATT -> ATGGCAAAGCAGGCGATTG
AACTATTGAATCTCCGAAG -> ACTATTGAATCTCCGAAGT
TCTTTGTGTTGCCCCGTGC -> CTTTGTGTTGCCCCGTGCG
AGGCGCATAGCACCGCAAA -> GGCGCATAGCACCGCAAAG
ACAAAGCGGCCGCACTGTC -> CAAAGCGGCCGCACTGTCA
CTTATAATACGCGGCAGGT -> TTATAATACGCGGCAGGTT
TTCCCACTAAGACTTAGAA -> TCCCACTAAGACTTAGAAT
CTCGATAGTATTCATTCTG -> TCGATAGTATTCATTCTGG
TCCAACTTGAGAACTAGTT -> CCAACTTGAGAACTAGTTC
ACCGCAAAGTTGGAGAGTG -> CCGCAAAGTTGGAGAGTGA
CCCCCATATCAGCGAATCC -> CCCCATATCAGCGAATCCG
ATTCTAAAAGTGCGAAAGT -> TTCTAAAAGTGCGAAAGTG
GCCCTCAGCGCTAGACCAG -> CCCTCAGCGCTAGACCAGA
GTCCCAACTATTGAATCTC -> TCCCAACTATTGAATCTCC
AAAATGTAGAAATAGGAGG -> AAATGTAGAAATAGGAGGA
TGATCTGGAGAACGGCGTC -> GATCTGGAGAACGGCGTCA
AGGTTCCATTCTAGCGGAA -> GGTTCCATTCTAGCGGAAG
ATTTGTGCAGAGAATTCCA -> TTTGTGCAGAGAATTCCAC
TCAAGAAGGCCTTTACAAT -> CAAGAAGGCCTTTACAATT
AGTTCAACTCACTGGGTGT -> GTTCAACTCACTGGGTGTC
GTCCACGCCCAAAAGCATA -> TCCACGCCCAAAAGCATAA
AGTTGGAGAGTGACCGACA -> GTTGGAGAGTGACCGACAA
AGACATCAACTCACGGAGC -> GACATCAACTCACGGAGCT
CGTCTCATGATAAGCGGTA -> GTCTCATGATAAGCGGTAC
TCCCTTGTAGGACCTCAGA -> CCCTTGTAGGACCTCAGAG
ATTTATTTGCTAGCCGGTA -> TTTATTTGCTAGCCGGTAG
CCTAGTAATTGAGACATCA -> CTAGTAATTGAGACATCAA
TAGGGCGTTCAACATCCGT -> AGGGCGTTCAACATCCGTC
TATTTACTTATAATACGCG -> ATTTACTTATAATACGCGG
GATTGGACCCCCAGAGGGT -> ATTGGACCCCCAGAGGGTG
GACTATTTACTTATAATAC -> ACTATTTACTTATAATACG
GGTTTGCAGTTCAAAGATA -> GTTTGCAGTTCAAAGATAG
GCAGGAAACAAAGCGGCCG -> CAGGAAACAAAGCGGCCGC
CAGTTGGTAGATGTTAAGG -> AGTTGGTAGATGTTAAGGT
TATATCTTTGTGTTGCCCC -> ATATCTTTGTGTTGCCCCG
GGGGATTTGCCCCTCGATT -> GGGATTTGCCCCTCGATTC
CAACACACTGGAGGTTCCA -> AACACACTGGAGGTTCCAT
CGTTGCGTACCTCTATATC -> GTTGCGTACCTCTATATCT
ATGGCCGTTATATTTATTT -> TGGCCGTTATATTTATTTG
AGCCAAATGGCCGTTATAT -> GCCAAATGGCCGTTATATT
GGAGTTTCCCACTAAGACT -> GAGTTTCCCACTAAGACTT
GGTACTGATTCCTTTGCTG -> GTACTGATTCCTTTGCTGA
CCTTTGTTACAGCAATCAT -> CTTTGTTACAGCAATCATA
AAAACTCACCTGAACATCT -> AAACTCACCTGAACATCTC
GGCGAAGAAGTATATTCTG -> GCGAAGAAGTATATTCTGG
AGATCACGGAAAATGTAGA -> GATCACGGAAAATGTAGAA
TGAGGGTCCACGCCCAAAA -> GAGGGTCCACGCCCAAAAG
GCTTCTCAACGCCTCTGCA -> CTTCTCAACGCCTCTGCAA
AAAAGTGCGAAAGTGAAAA -> AAAGTGCGAAAGTGAAAAA
TCTAAAAGTGCGAAAGTGA -> CTAAAAGTGCGAAAGTGAA
CTATTTACTTATAATACGC -> TATTTACTTATAATACGCG
AAGAAGTATATTCTGGTAC -> AGAAGTATATTCTGGTACT
CAGTAAGCCACTAAGCGTT -> AGTAAGCCACTAAGCGTTA
GTTCAAAACGGACAAAAGC -> TTCAAAACGGACAAAAGCG
CGGCTAGATCAAGAAGGCC -> GGCTAGATCAAGAAGGCCT
GAGTTTCCCACTAAGACTT -> AGTTTCCCACTAAGACTTA
CCGAACACCCCTTAAGAGC -> CGAACACCCCTTAAGAGCC
AAGACTTAGAATACCAAGA -> AGACTTAGAATACCAAGAT
CTCTGTGACCCCCCCCATA -> TCTGTGACCCCCCCCATAT
GGCAGATTCGGGTGAACGG -> GCAGATTCGGGTGAACGGA
GGTGCGCCTGCGCAAGATG -> GTGCGCCTGCGCAAGATGG
CTAATTTCCTTTGTTACAG -> TAATTTCCTTTGTTACAGC
CCCTTGTAGGACCTGTAGC -> CCTTGTAGGACCTGTAGCA
ATAAGCCAGTGACCTATGA -> TAAGCCAGTGACCTATGAT
GAACGGACATGGTGGGAAC -> AACGGACATGGTGGGAACA
GACCATCCGCTCGGTAAGT -> ACCATCCGCTCGGTAAGTG
TGTTAAGGTATGCGCTGAG -> GTTAAGGTATGCGCTGAGG
CTCATAACCTATGCCTTGC -> TCATAACCTATGCCTTGCC
TGACCTATGATGAGGCGCA -> GACCTATGATGAGGCGCAT
TGTCCATCCCGTTTTCGAG -> GTCCATCCCGTTTTCGAGG
GGCAGGTTGATGCGTCGTT -> GCAGGTTGATGCGTCGTTG
CCAAAAGCATAACGTAGCT -> CAAAAGCATAACGTAGCTG
AGATGTACCAAGGCCGTTA -> GATGTACCAAGGCCGTTAT
GCATAGCACCGCAAAGTTG -> CATAGCACCGCAAAGTTGG
CTCTATATCTTTGTGTTGC -> TCTATATCTTTGTGTTGCC
TTCCCTTGGCTAATGTCCG -> TCCCTTGGCTAATGTCCGT
CCAGATGGCCATCGCTCGA -> CAGATGGCCATCGCTCGAT
CCCACATGGCAAAGCAGGC -> CCACATGGCAAAGCAGGCG
GGGTGGCCCTCAGCGCTAG -> GGTGGCCCTCAGCGCTAGA
CGGACAAAAGCGGATTGAC -> GGACAAAAGCGGATTGACC
ACGTCAAGTGTACGTTCGG -> CGTCAAGTGTACGTTCGGG
ACCCTCTTGCCTAGTACAC -> CCCTCTTGCCTAGTACACA
AACATCTCCCCCAGGGCTT -> ACATCTCCCCCAGGGCTTA
TGCCTGTTTCCCTTGCCTA -> GCCTGTTTCCCTTGCCTAG
ATTTTAGCGCGTCGATAGG -> TTTTAGCGCGTCGATAGGG
TGTAGCACCGTTCAAAACG -> GTAGCACCGTTCAAAACGG
AAAGCATAACGTAGCTGGA -> AAGCATAACGTAGCTGGAC
CACTAAGACTTAGAATACC -> ACTAAGACTTAGAATACCA
TCACACGGTGCGCCTGCGC -> CACACGGTGCGCCTGCGCA
TACCGTGATCTGGAGAACG -> ACCGTGATCTGGAGAACGG
CTGGCCGGGGCGGCCGTTA -> TGGCCGGGGCGGCCGTTAT
AGAGAATTCCACTCCCTTG -> GAGAATTCCACTCCCTTGT
CAAAACCCTCTTGCCTAGT -> AAAACCCTCTTGCCTAGTA
TTACGGGCGAAGAAGTATA -> TACGGGCGAAGAAGTATAT
TCAACTCACGGAGCTGACG -> CAACTCACGGAGCTGACGC
GGTTCCATTCTAGCGGAAG -> GTTCCATTCTAGCGGAAGG
GGCTAGATCAAGAAGGCCT -> GCTAGATCAAGAAGGCCTT
GATGTGCAGTAAGCCACTA -> ATGTGCAGTAAGCCACTAA
TCAATGCTGCATCTGTCAG -> CAATGCTGCATCTGTCAGC
AGTATGGGCGCGACAAAGC -> GTATGGGCGCGACAAAGCC
TAGAATACCAAGATCACGG -> AGAATACCAAGATCACGGA
AGTAAGCCACTAAGCGTTA -> GTAAGCCACTAAGCGTTAA
TGTGTTGCCCCGTGCGGGT -> GTGTTGCCCCGTGCGGGTG
CCGCACTGTCAATGCTGCA -> CGCACTGTCAATGCTGCAT
ATAAGCGGTACGTCAAGTG -> TAAGCGGTACGTCAAGTGT
ATGTGCGGACAATTCTTCC -> TGTGCGGACAATTCTTCCC
TGACCCCCCCCATATCAGC -> GACCCCCCCCATATCAGCG
ATACCAAGATCACGGAAAA -> TACCAAGATCACGGAAAAT
AGTACAAATGCCCCGCACC -> GTACAAATGCCCCGCACCC
TCCCGACCATTTTGAGAAC -> CCCGACCATTTTGAGAACC
AGCTGGACTCCAGTACAAA -> GCTGGACTCCAGTACAAAT
ACCCCCCCCATATCAGCGA -> CCCCCCCCATATCAGCGAA
AGTGACCGACAAAGTTCCG -> GTGACCGACAAAGTTCCGG
ATCAACTCACGGAGCTGAC -> TCAACTCACGGAGCTGACG
CGGTAGCCACTCCCTTGTA -> GGTAGCCACTCCCTTGTAG
GTGTCAGGTTTCGACAGTT -> TGTCAGGTTTCGACAGTTG
TTACAGCAATCATAAGCCA -> TACAGCAATCATAAGCCAG
CGACAGTTGGTAGATGTTA -> GACAGTTGGTAGATGTTAA
AGCGGAAGGCGTGCGTCAT -> GCGGAAGGCGTGCGTCATA
TGGAGAACGGCGTCAGTAC -> GGAGAACGGCGTCAGTACG
TCAAAGATAGACATCTCCG -> CAAAGATAGACATCTCCGT
CTTGAAACGGGCAAGAGGC -> TTGAAACGGGCAAGAGGCA
ATACGGTTGCTTTTGGGGG -> TACGGTTGCTTTTGGGGGG
GGGATTGGACGTAAATCCT -> GGATTGGACGTAAATCCTG
AGGTCTAGGGCGATACCCG -> GGTCTAGGGCGATACCCGG
TGCAGAGAATTCCACTCCC -> GCAGAGAATTCCACTCCCT
TGTTGCCCCGTGCGGGTGT -> GTTGCCCCGTGCGGGTGTC
AGGGGTGGTCGACACTACC -> GGGGTGGTCGACACTACCC
ATTGCTAAGGAATACGATG -> TTGCTAAGGAATACGATGG
GCGTCGTTGCGTACCTCTA -> CGTCGTTGCGTACCTCTAT
GTAGGACCTTAAGTGCTAA -> TAGGACCTTAAGTGCTAAT
ATCAGCGAATCCGTGCAGG -> TCAGCGAATCCGTGCAGGA
TTGAAACGGGCAAGAGGCA -> TGAAACGGGCAAGAGGCAG
TGGTGGGAACACAAGGTAC -> GGTGGGAACACAAGGTACT
AAAGCGGATTGACCATCCG -> AAGCGGATTGACCATCCGC
CTCCCCCAGGGCTTATTAT -> TCCCCCAGGGCTTATTATA
AAGTGCTAATCGCAGGTTA -> AGTGCTAATCGCAGGTTAG
CACTGGAGGTTCCATTCTA -> ACTGGAGGTTCCATTCTAG
CCGGTGTCCATCCCGTTTT -> CGGTGTCCATCCCGTTTTC
TCTCCGTGAAACGCCCTAG -> CTCCGTGAAACGCCCTAGT
ACTGATTCCTTTGCTGATT -> CTGATTCCTTTGCTGATTG
GGACAAAAGCGGATTGACC -> GACAAAAGCGGATTGACCA
GAAAAAGATTGCACAAGTA -> AAAAAGATTGCACAAGTAG
CTTGATTCATGCTGCCCTA -> TTGATTCATGCTGCCCTAA
GCGCAGCCGCTCTACTTGA -> CGCAGCCGCTCTACTTGAC
GTGGCCCTCAGCGCTAGAC -> TGGCCCTCAGCGCTAGACC
GATAGTATTCATTCTGGTG -> ATAGTATTCATTCTGGTGG
TACGCGGCAGGTTGATGCG -> ACGCGGCAGGTTGATGCGT
ATTTGGTCCGTACTCCCCA -> TTTGGTCCGTACTCCCCAC
CGTATGTTTTGCGATCCCG -> GTATGTTTTGCGATCCCGG
CCGCTCGGTAAGTGGTGGT -> CGCTCGGTAAGTGGTGGTC
AACCCGTGTATTTGAGGAT -> ACCCGTGTATTTGAGGATG
TTCGATCTTGAAACGGGCA -> TCGATCTTGAAACGGGCAA
ATTCGTTTTATCGCGCAGC -> TTCGTTTTATCGCGCAGCC
GTACGTCAAGTGTACGTTC -> TACGTCAAGTGTACGTTCG
CCCCAGAGGGTGTCATCTG -> CCCAGAGGGTGTCATCTGC
GGCAAAGCAGGCGATTGGA -> GCAAAGCAGGCGATTGGAC
CATCCGTCTCATGATAAGC -> ATCCGTCTCATGATAAGCG
GGACAATTCTTCCCTTGGC -> GACAATTCTTCCCTTGGCT
GGGAACACAAGGTACTCCG -> GGAACACAAGGTACTCCGC
CCGTGTATTTGAGGATGCC -> CGTGTATTTGAGGATGCCC
GCGGGTGTCAGGTTTCGAC -> CGGGTGTCAGGTTTCGACA
CCGGCTAGATCAAGAAGGC -> CGGCTAGATCAAGAAGGCC
AGGTTAGTCACGGAGTGAA -> GGTTAGTCACGGAGTGAAT
GTCATAGCCAGGCAACGGT -> TCATAGCCAGGCAACGGTT
GGTCCGTACTCCCCACTCC -> GTCCGTACTCCCCACTCCC
AGGCAACGGTTTTCCTAAT -> GGCAACGGTTTTCCTAATT
GTAAGTGGTGGTCGAATGC -> TAAGTGGTGGTCGAATGCT
CGCGCAGCCGCTCTACTTG -> GCGCAGCCGCTCTACTTGA
ATCCGCTCGGTAAGTGGTG -> TCCGCTCGGTAAGTGGTGG
AGTGACCTATGATGAGGCG -> GTGACCTATGATGAGGCGC
CTCGGTAAGTGGTGGTCGA -> TCGGTAAGTGGTGGTCGAA
CAAGAAGGCCTTTACAATT -> AAGAAGGCCTTTACAATTG
GTCGAATGCTCTGGGGATT -> TCGAATGCTCTGGGGATTG
TTCGGGGATTTGCCCCTCG -> TCGGGGATTTGCCCCTCGA
AAAGATTGCACAAGTAGTG -> AAGATTGCACAAGTAGTGT
CCGTACTCCCCACTCCCTT -> CGTACTCCCCACTCCCTTG
ACTATTTACTTATAATACG -> CTATTTACTTATAATACGC
TCAGTGTCTATTCGATCTT -> CAGTGTCTATTCGATCTTG
GCTGACGCCCCTCCTAGAC -> CTGACGCCCCTCCTAGACG
TTCCCTAGATGGCGTCTCA -> TCCCTAGATGGCGTCTCAG
TCCAAACCGTCCTCATAAC -> CCAAACCGTCCTCATAACC
ATTGACCATCCGCTCGGTA -> TTGACCATCCGCTCGGTAA
GTTTTCGAGGTCACGTCGC -> TTTTCGAGGTCACGTCGCT
AACCCATCAGCATACCCTG -> ACCCATCAGCATACCCTGG
AAAAGCATAACGTAGCTGG -> AAAGCATAACGTAGCTGGA
ATGTCCAACCCATCAGCAT -> TGTCCAACCCATCAGCATA
TACGTTCGGGGATTTGCCC -> ACGTTCGGGGATTTGCCCC
TATGTCCAACCCATCAGCA -> ATGTCCAACCCATCAGCAT
CCGCACCCTTCCAAACCGT -> CGCACCCTTCCAAACCGTC
GGTTAGTCACGGAGTGAAT -> GTTAGTCACGGAGTGAATT
ACATCCGTCTCATGATAAG -> CATCCGTCTCATGATAAGC
GTTCCGGTGTCCATCCCGT -> TTCCGGTGTCCATCCCGTT
GCTGAGGGGCACCAACACA -> CTGAGGGGCACCAACACAC
GGTTTTCCTAATTTCCTTT -> GTTTTCCTAATTTCCTTTG
GTACAGGTGAATGCCTTGA -> TACAGGTGAATGCCTTGAT
GCCGGTAGCCACTCCCTTG -> CCGGTAGCCACTCCCTTGT
TCCCACTAAGACTTAGAAT -> CCCACTAAGACTTAGAATA
AATTCGTTTTATCGCGCAG -> ATTCGTTTTATCGCGCAGC
GGCGCGGCGAACTACTTGT -> GCGCGGCGAACTACTTGTG
GATCTGGAGAACGGCGTCA -> ATCTGGAGAACGGCGTCAG
ACACGTATGTTTTGCGATC -> CACGTATGTTTTGCGATCC
AAGCAGGCGATTGGACCCC -> AGCAGGCGATTGGACCCCC
GTCTTGACTATTTACTTAT -> TCTTGACTATTTACTTATA
TACTGATTCCTTTGCTGAT -> ACTGATTCCTTTGCTGATT
CAAAAGCATAACGTAGCTG -> AAAAGCATAACGTAGCTGG
CGTTCAACATCCGTCTCAT -> GTTCAACATCCGTCTCATG
TATATGTGCGGACAATTCT -> ATATGTGCGGACAATTCTT
TTTTCCTAATTTCCTTTGT -> TTTCCTAATTTCCTTTGTT
AGGAGGAGGGGACTGGAGG -> GGAGGAGGGGACTGGAGGG
TTGACCATCCGCTCGGTAA -> TGACCATCCGCTCGGTAAG
TGGGAACACAAGGTACTCC -> GGGAACACAAGGTACTCCG
TGGCGTCTCAGTGTCTATT -> GGCGTCTCAGTGTCTATTC
CTGTCAATGCTGCATCTGT -> TGTCAATGCTGCATCTGTC
GGAGGGGACTGGAGGGTAC -> GAGGGGACTGGAGGGTACT
TATCAGCGAATCCGTGCAG -> ATCAGCGAATCCGTGCAGG
TATGCGCTGAGGGGCACCA -> ATGCGCTGAGGGGCACCAA
AAGGGGACGAATTCGTTTT -> AGGGGACGAATTCGTTTTA
ATGTCCGTTCATACGGTTG -> TGTCCGTTCATACGGTTGC
AGGGGACTGGAGGGTACTT -> GGGGACTGGAGGGTACTTG
TATTTGGTCCGTACTCCCC -> ATTTGGTCCGTACTCCCCA
TGATTCCTTTGCTGATTGC -> GATTCCTTTGCTGATTGCT
TAGACATCTCCGTGAAACG -> AGACATCTCCGTGAAACGC
ATGGAAGCATGAAGGCCTG -> TGGAAGCATGAAGGCCTGA
TGACTATTTACTTATAATA -> GACTATTTACTTATAATAC
ACGATGGGTTAGTATCTTA -> CGATGGGTTAGTATCTTAG
CGAAGAAGTATATTCTGGT -> GAAGAAGTATATTCTGGTA
ATATTTATTTGGTCCGTAC -> TATTTATTTGGTCCGTACT
CGCCTGCGCAAGATGGAAA -> GCCTGCGCAAGATGGAAAA
ATTTATTTGGTCCGTACTC -> TTTATTTGGTCCGTACTCC
TCAACGCCTCTGCAAAACC -> CAACGCCTCTGCAAAACCC
CAAAGCAGGCGATTGGACC -> AAAGCAGGCGATTGGACCC
CGTGCGTCATAGCCAGGCA -> GTGCGTCATAGCCAGGCAA
GGGATTTGCCCCTCGATTC -> GGATTTGCCCCTCGATTCC
ATCTGCGTACAGGTGAATG -> TCTGCGTACAGGTGAATGC
TGTATTTGAGGATGCCCCA -> GTATTTGAGGATGCCCCAC
GGTGAATGCCTTGATTCAT -> GTGAATGCCTTGATTCATG
CGACAAAGTTCCGGTGTCC -> GACAAAGTTCCGGTGTCCA
CCAAGGATTTTAGCGCGTC -> CAAGGATTTTAGCGCGTCG
GATGTACCAAGGCCGTTAT -> ATGTACCAAGGCCGTTATA
GGGGCACCAACACACTGGA -> GGGCACCAACACACTGGAG
TGGCCCTCAGCGCTAGACC -> GGCCCTCAGCGCTAGACCA
TTCCCTTGCCTAGATGTAC -> TCCCTTGCCTAGATGTACC
CCGGGGCGGCCGTTATATT -> CGGGGCGGCCGTTATATTT
GGCCGCACTGTCAATGCTG -> GCCGCACTGTCAATGCTGC
ATACCCTGGAGAGGCCCAC -> TACCCTGGAGAGGCCCACA
CCCCTTAAGAGCCAAGGAT -> CCCTTAAGAGCCAAGGATT
ATCCTGGTCTTGACTATTT -> TCCTGGTCTTGACTATTTA
TAGCTGGACTCCAGTACAA -> AGCTGGACTCCAGTACAAA
CCCAGGGCTTATTATATGT -> CCAGGGCTTATTATATGTG
GTGGTCGAATGCTCTGGGG -> TGGTCGAATGCTCTGGGGA
GGTCACGTCGCTACTGTCC -> GTCACGTCGCTACTGTCCA
TGTACCAAGGCCGTTATAT -> GTACCAAGGCCGTTATATT
ATGGCAAAGCAGGCGATTG -> TGGCAAAGCAGGCGATTGG
TGGCCATCGCTCGATAGTA -> GGCCATCGCTCGATAGTAT
AAGTGCGAAAGTGAAAAAG -> AGTGCGAAAGTGAAAAAGA
CGTGTATTTGAGGATGCCC -> GTGTATTTGAGGATGCCCC
TCCCTTGTAGGACCTGGGA -> CCCTTGTAGGACCTGGGAC
GACATCTCCGTGAAACGCC -> ACATCTCCGTGAAACGCCC
TAGGAGGAGGGGACTGGAG -> AGGAGGAGGGGACTGGAGG
CGTTCCCTGAACCGGCGAG -> GTTCCCTGAACCGGCGAGC
TCGCTCGATAGTATTCATT -> CGCTCGATAGTATTCATTC
CCCTTGCCTAGATGTACCA -> CCTTGCCTAGATGTACCAA
TGAGGCGCATAGCACCGCA -> GAGGCGCATAGCACCGCAA
GCGAATCCGTGCAGGAAAC -> CGAATCCGTGCAGGAAACA
CATCAACTCACGGAGCTGA -> ATCAACTCACGGAGCTGAC
TACGATGGGTTAGTATCTT -> ACGATGGGTTAGTATCTTA
GGAAGCATGAAGGCCTGAC -> GAAGCATGAAGGCCTGACT
CACGGAAAATGTAGAAATA -> ACGGAAAATGTAGAAATAG
CACACTGGAGGTTCCATTC -> ACACTGGAGGTTCCATTCT
CATCAGCATACCCTGGAGA -> ATCAGCATACCCTGGAGAG
ATGGCGTCTCAGTGTCTAT -> TGGCGTCTCAGTGTCTATT
GGCGAACTACTTGTGAGGA -> GCGAACTACTTGTGAGGAA
CGACAAAGCCGGGGCTTGC -> GACAAAGCCGGGGCTTGCT
ACTCCCCACTCCCTTGTAG -> CTCCCCACTCCCTTGTAGG
GCGCCGCAGTGCGTTGCTA -> CGCCGCAGTGCGTTGCTAA
GAATCCGAACACCCCTTAA -> AATCCGAACACCCCTTAAG
TATTTGAATTTTGCGACCC -> ATTTGAATTTTGCGACCCA
CTTCACACGGTGCGCCTGC -> TTCACACGGTGCGCCTGCG
CCAGTGACCTATGATGAGG -> CAGTGACCTATGATGAGGC
GCTAGATCAAGAAGGCCTT -> CTAGATCAAGAAGGCCTTT
GGTCCACGCCCAAAAGCAT -> GTCCACGCCCAAAAGCATA
TGCAGTAAGCCACTAAGCG -> GCAGTAAGCCACTAAGCGT
AGATGGAAGCATGAAGGCC -> GATGGAAGCATGAAGGCCT
CCCAACTATTGAATCTCCG -> CCAACTATTGAATCTCCGA
CAGTACGTATGTCCAACCC -> AGTACGTATGTCCAACCCA
TTCAAAGATAGACATCTCC -> TCAAAGATAGACATCTCCG
AGCGAATCCGTGCAGGAAA -> GCGAATCCGTGCAGGAAAC
GAGCCAAATGGCCGTTATA -> AGCCAAATGGCCGTTATAT
CGGAGCTGACGCCCCTCCT -> GGAGCTGACGCCCCTCCTA
TTTGAGGATGCCCCACTGG -> TTGAGGATGCCCCACTGGC
GGAAGCCATACCGTGATCT -> GAAGCCATACCGTGATCTG
CCAAGATCACGGAAAATGT -> CAAGATCACGGAAAATGTA
GAGTATGGGCGCGACAAAG -> AGTATGGGCGCGACAAAGC
TTTCGAGGTCACGTCGCTA -> TTCGAGGTCACGTCGCTAC
CCCGCACCCTTCCAAACCG -> CCGCACCCTTCCAAACCGT
ACACTGGAGGTTCCATTCT -> CACTGGAGGTTCCATTCTA
GCGGATTGACCATCCGCTC -> CGGATTGACCATCCGCTCG
TCCTTTGTTACAGCAATCA -> CCTTTGTTACAGCAATCAT
TCAGAGTATTACCTGCGTT -> CAGAGTATTACCTGCGTTC
CTCCGTGAAACGCCCTAGT -> TCCGTGAAACGCCCTAGTA
GCGTACAGGTGAATGCCTT -> CGTACAGGTGAATGCCTTG
TGCCTTGCCTGGAGTATGG -> GCCTTGCCTGGAGTATGGG
CTGGAGTATGGGCGCGACA -> TGGAGTATGGGCGCGACAA
AAGCGGATTGACCATCCGC -> AGCGGATTGACCATCCGCT
GAAGGCGTGCGTCATAGCC -> AAGGCGTGCGTCATAGCCA
GGTACTCCGCTCGCATAAT -> GTACTCCGCTCGCATAATG
AAGCCACTAAGCGTTAAGA -> AGCCACTAAGCGTTAAGAA
AGAGTATTACCTGCGTTCC -> GAGTATTACCTGCGTTCCC
TAGCGGAAGGCGTGCGTCA -> AGCGGAAGGCGTGCGTCAT
CGGGCAAGAGGCAGATTCG -> GGGCAAGAGGCAGATTCGG
CCACGCCCAAAAGCATAAC -> CACGCCCAAAAGCATAACG
TCGAGGTCACGTCGCTACT -> CGAGGTCACGTCGCTACTG
ATCCCGGCTAGATCAAGAA -> TCCCGGCTAGATCAAGAAG
CTCACCTGAACATCTCCCC -> TCACCTGAACATCTCCCCC
CCGTTATATTTATTTGCTA -> CGTTATATTTATTTGCTAG
ATTCATGCTGCCCTAAGGG -> TTCATGCTGCCCTAAGGGG
AGAAGGCCTTTACAATTGG -> GAAGGCCTTTACAATTGGA
GGTGGGAACACAAGGTACT -> GTGGGAACACAAGGTACTC
TGAATTTTGCGACCCACTC -> GAATTTTGCGACCCACTCC
GATGGCGTCTCAGTGTCTA -> ATGGCGTCTCAGTGTCTAT
TTAGTAGGTCTAGGGCGAT -> TAGTAGGTCTAGGGCGATA
TGAAGGCCTGACTTTCGTG -> GAAGGCCTGACTTTCGTGG
GCGATACCCGGAGCAGGGT -> CGATACCCGGAGCAGGGTG
GTGCAGTAAGCCACTAAGC -> TGCAGTAAGCCACTAAGCG
GGAGGTTCCATTCTAGCGG -> GAGGTTCCATTCTAGCGGA
CTCAGAGTATTACCTGCGT -> TCAGAGTATTACCTGCGTT
GGGTACTTGATGTGCAGTA -> GGTACTTGATGTGCAGTAA
AGGACCTTAAGTGCTAATC -> GGACCTTAAGTGCTAATCG
TGTAGGACCTCAGAGTATT -> GTAGGACCTCAGAGTATTA
AATACCAAGATCACGGAAA -> ATACCAAGATCACGGAAAA
ATGCTCTGGGGATTGGACG -> TGCTCTGGGGATTGGACGT
CCGACCATTTTGAGAACCG -> CGACCATTTTGAGAACCGG
GGTGGTCGAATGCTCTGGG -> GTGGTCGAATGCTCTGGGG
CCTCCTAGACGCTGGCGCC -> CTCCTAGACGCTGGCGCCG
CCAGGCAACGGTTTTCCTA -> CAGGCAACGGTTTTCCTAA
AGTTCCGGTGTCCATCCCG -> GTTCCGGTGTCCATCCCGT
ACGTTCGGGGATTTGCCCC -> CGTTCGGGGATTTGCCCCT
ACTACCCTAGCTCTGTGAC -> CTACCCTAGCTCTGTGACC
AACACAAGGTACTCCGCTC -> ACACAAGGTACTCCGCTCG
CCAACGAAGGCGCGGCGAA -> CAACGAAGGCGCGGCGAAC
TCCACGCCCAAAAGCATAA -> CCACGCCCAAAAGCATAAC
CCCCCCCATATCAGCGAAT -> CCCCCCATATCAGCGAATC
CAAGGCCGTTATATTTATT -> AAGGCCGTTATATTTATTT
TAGCCACTCCCTTGTAGGA -> AGCCACTCCCTTGTAGGAC
ACCCATCAGCATACCCTGG -> CCCATCAGCATACCCTGGA
ATCCCGTTTTCGAGGTCAC -> TCCCGTTTTCGAGGTCACG
GCATTCTAAAAGTGCGAAA -> CATTCTAAAAGTGCGAAAG
GATGGGTTAGTATCTTAGG -> ATGGGTTAGTATCTTAGGG
GGACATGGTGGGAACACAA -> GACATGGTGGGAACACAAG
